,puma,Total_geo,Total_geo_m,Total_geo_f,Total_Avg_PINCP_mf_t,Total_Avg_PINCP_m,Total_Avg_PINCP_f,Total_BABS,Total_BABS_m,Total_BABS_f,BABS_Avg_PINCP_mf_t,BABS_Avg_PINCP_m,BABS_Avg_PINCP_f,Total_HS,Total_HS_m,Total_HS_f,HS_Avg_PINCP_mf_t,HS_Avg_PINCP_m,HS_Avg_PINCP_f,Total_HSINC,Total_HSINC_m,Total_HSINC_f,HSINC_Avg_PINCP_mf_t,HSINC_Avg_PINCP_m,HSINC_Avg_PINCP_f
0,Total Geo,387089,247364,139725,46724.971298590244,48728.96589236914,43177.172989801395,96679,50089,46590,74584.00909194344,84781.53766295993,63620.62620734063,219388,142220,77168,38506.5697348989,40941.516242441285,34018.98301109268,71022,55055,15967,34188.500450564614,36045.1737171919,27786.59986221582
1,Nassau County (Central)--Hempstead Town (Northeast) PUMA,2966,1978,988,70672.96021577883,76677.45197168857,58651.82186234818,768,329,439,81520.83333333333,102693.00911854103,65653.75854214124,2065,1516,549,66681.8401937046,71617.4142480211,53052.823315118396,133,133,0,70000.0,70000.0,0.0
2,"Chenango, Delaware & Broome (East) Counties PUMA",143,143,0,23190.20979020979,23190.20979020979,0.0,8,8,0,22900.0,22900.0,0.0,135,135,0,23207.40740740741,23207.40740740741,0.0,0,0,0,#DIV/0!,0.0,0.0
3,Cayuga & Onondaga (South) Counties PUMA,0,0,0,#DIV/0!,0.0,0.0,0,0,0,#DIV/0!,0.0,0.0,0,0,0,#DIV/0!,0.0,0.0,0,0,0,#DIV/0!,0.0,0.0
4,NYC-Brooklyn Community District 5--East New York & Starrett City PUMA,7258,4213,3045,36931.70294847065,37925.20769048184,35557.11001642036,1126,390,736,43768.65008880995,34792.307692307695,48525.135869565216,4372,2629,1743,39837.145471180236,41636.744009128946,37122.776821572,1760,1194,566,25340.227272727272,30776.298157453937,13872.6148409894
5,"NYC-Staten Island Community District 1--Port Richmond, Stapleton & Mariner's Harbor PUMA",6403,3694,2709,43645.06325160081,43004.52084461289,44518.50867478774,991,469,522,77148.33501513622,47507.46268656717,103779.69348659004,3748,2151,1597,39212.36392742796,43356.0669456067,33631.20851596744,1664,1074,590,33676.32211538462,40334.0782122905,21556.949152542373
6,"NYC-Queens Community District 5--Ridgewood, Glendale & Middle Village PUMA",7671,4329,3342,42400.15082779299,43665.74266574266,40760.78904847397,1403,414,989,63735.28153955809,67012.077294686,62363.59959555106,4589,2700,1889,39553.945739812596,43596.51851851852,33775.78454208576,1679,1215,464,32351.340083382966,35864.52674897119,23151.939655172413
7,"Otsego, Schoharie, Oneida (South) & Herkimer (South) Counties PUMA",60,0,60,50133.333333333336,0.0,50133.333333333336,28,0,28,80000.0,0.0,80000.0,32,0,32,24000.0,0.0,24000.0,0,0,0,#DIV/0!,0.0,0.0
8,Erie County (Northwest) PUMA,0,0,0,#DIV/0!,0.0,0.0,0,0,0,#DIV/0!,0.0,0.0,0,0,0,#DIV/0!,0.0,0.0,0,0,0,#DIV/0!,0.0,0.0
9,NYC-Manhattan Community District 7--Upper West Side & West Side PUMA,2486,1706,780,88044.74658085278,83058.7573270809,98950.0,1486,706,780,123313.08209959623,150229.8016997167,98950.0,812,812,0,26522.16748768473,26522.16748768473,0.0,188,188,0,75000.0,75000.0,0.0
10,"NYC-Manhattan Community District 6--Murray Hill, Gramercy & Stuyvesant Town PUMA",1183,737,446,243076.58495350802,238048.3039348711,251385.65022421523,1183,737,446,243076.58495350802,238048.3039348711,251385.65022421523,0,0,0,#DIV/0!,0.0,0.0,0,0,0,#DIV/0!,0.0,0.0
11,Saratoga County (South & Central) PUMA,353,272,81,62939.830028328615,56370.44117647059,85000.0,272,272,0,56370.44117647059,56370.44117647059,0.0,81,0,81,85000.0,0.0,85000.0,0,0,0,#DIV/0!,0.0,0.0
12,Nassau County (South Central)--Hempstead Town (Southeast) PUMA,1168,615,553,100009.41780821918,150975.60975609755,43329.11392405063,800,435,365,137456.25,209310.3448275862,51821.91780821918,188,0,188,26840.425531914894,0.0,26840.425531914894,180,180,0,10000.0,10000.0,0.0
13,Columbia & Greene Counties PUMA,148,128,20,37702.7027027027,40781.25,18000.0,57,57,0,25000.0,25000.0,0.0,46,26,20,75652.17391304347,120000.0,18000.0,45,45,0,15000.0,15000.0,0.0
14,NYC-Staten Island Community District 2--New Springville & South Beach PUMA,1408,993,415,34299.005681818184,33439.87915407855,36354.698795180724,370,114,256,50400.54054054054,71000.0,41227.34375,1038,879,159,28559.537572254336,28568.600682593857,28509.43396226415,0,0,0,#DIV/0!,0.0,0.0
15,Nassau County (Northeast)--Oyster Bay Town (North) & Glen Cove City PUMA,3547,2673,874,49326.18550888074,52594.081556303776,39331.80778032036,355,22,333,80647.88732394367,250000.0,69459.45945945945,1782,1241,541,25736.868686868685,27894.520547945205,20787.43068391867,1410,1410,0,71253.10638297872,71253.10638297872,0.0
16,NYC-Brooklyn Community District 18--Canarsie & Flatlands PUMA,2396,1302,1094,47829.732888146915,43931.79723502304,52468.775137111516,1247,635,612,62210.42502004812,64011.65354330709,60341.50326797386,546,64,482,38314.72527472527,7000.0,42472.69709543569,603,603,0,26706.135986733003,26706.135986733003,0.0
17,Putnam County PUMA,1792,1463,329,51189.39732142857,57157.758031442245,24649.240121580548,81,49,32,111654.32098765433,116000.0,105000.0,1472,1175,297,53729.211956521736,63267.914893617024,15991.919191919193,239,239,0,15054.393305439331,15054.393305439331,0.0
18,Nassau County (Northwest)--North Hempstead Town (North) PUMA,1817,1349,468,36837.644468904786,32633.061527057078,48957.26495726496,404,258,146,52589.10891089109,28023.25581395349,96000.0,1156,834,322,31685.121107266437,33251.79856115108,27627.329192546586,257,257,0,35252.91828793774,35252.91828793774,0.0
19,NYC-Queens Community District 3--Jackson Heights & North Corona PUMA,17097,12256,4841,33621.20021056326,34913.32408616188,30349.919438132616,1339,930,409,40651.65048543689,47211.82795698925,25734.865525672372,13228,9255,3973,32761.71756879347,34135.2566180443,29562.094135414045,2530,2071,459,34394.11067193676,32867.64847899565,41281.48148148148
20,Rockland County (North)--New City & Congers PUMA,2420,1577,843,42571.38842975206,49712.65694356373,29212.218268090153,715,487,228,82233.37062937063,105751.25256673511,32000.0,1157,622,535,25642.09161624892,27617.363344051446,23345.607476635512,548,468,80,26565.693430656935,20764.957264957266,60500.0
21,"NYC-Bronx Community District 3 & 6--Belmont, Crotona Park East & East Tremont PUMA",8952,4976,3976,33261.11595174263,37218.579180064306,28308.314889336016,2628,1798,830,44271.232876712325,47798.66518353726,36629.87951807229,4251,2158,2093,30451.472594683604,35653.40593141798,25087.988533205924,2073,1020,1053,25064.88181379643,21880.0,28149.95251661918
22,Orange County (Northwest) PUMA,2867,1749,1118,61896.09347750262,72512.06403659233,45288.46153846154,883,267,616,68507.13476783692,89182.77153558053,59545.454545454544,1628,1126,502,65832.49385749386,82791.1190053286,27793.82470119522,356,356,0,27497.191011235955,27497.191011235955,0.0
23,NYC-Brooklyn Community District 2--Brooklyn Heights & Fort Greene PUMA,729,233,496,126825.17146776406,42343.34763948498,166511.18951612903,332,0,332,92558.88554216867,0.0,92558.88554216867,397,233,164,155481.10831234258,42343.34763948498,316219.51219512196,0,0,0,#DIV/0!,0.0,0.0
24,Dutchess County (Southwest) PUMA,1527,1163,364,43579.27963326785,44367.153912295784,41061.97802197802,401,243,158,89138.5536159601,99423.8683127572,73320.0,1060,854,206,27812.264150943396,30584.30913348946,16320.388349514564,66,66,0,20000.0,20000.0,0.0
25,Westchester County (Northwest) PUMA,5957,3689,2268,27924.89508141682,27625.237191650853,28412.301587301587,1928,645,1283,36010.11410788382,41012.40310077519,33495.32346063913,2436,1736,700,24256.1986863711,26717.45391705069,18152.285714285714,1593,1308,285,23749.529190207155,22228.593272171252,30729.824561403508
26,Nassau County (Southeast)--Oyster Bay Town (South) PUMA,2760,1564,1196,39485.663043478264,39698.33759590793,39207.55016722408,721,216,505,56101.24826629681,40000.0,62988.11881188119,1963,1272,691,33451.976566479876,39766.50943396227,21828.11866859624,76,76,0,37700.0,37700.0,0.0
27,Westchester County (South Central)--New Rochelle & Mount Vernon Cities PUMA,4243,3032,1211,49965.78246523686,50627.09729551451,48310.03798513625,1228,454,774,59069.46254071661,56905.28634361234,60338.88888888889,1398,1309,89,42333.80257510729,40928.41864018334,63004.0,1617,1269,348,49650.50030921459,58385.38928289992,17798.275862068964
28,Saratoga County (Outer) PUMA,24,24,0,23000.0,23000.0,0.0,0,0,0,#DIV/0!,0.0,0.0,0,0,0,#DIV/0!,0.0,0.0,24,24,0,23000.0,23000.0,0.0
29,NYC-Queens Community District 9--Richmond Hill & Woodhaven PUMA,9671,6894,2777,51497.30327784097,53058.21003771396,47622.29744328412,3108,1997,1111,72455.47619047618,73551.62744116175,70485.16651665166,5087,3624,1463,42185.70866915667,46462.91390728477,31590.635680109364,1476,1273,203,39458.0623306233,39685.07462686567,38034.48275862069
30,Erie County (South) PUMA,348,215,133,31045.97701149425,34786.04651162791,25000.0,250,117,133,27808.0,31000.0,25000.0,98,98,0,39306.12244897959,39306.12244897959,0.0,0,0,0,#DIV/0!,0.0,0.0
31,"NYC-Queens Community District 12--Jamaica, Hollis & St. Albans PUMA",5163,2972,2191,33664.22622506295,36807.20053835801,29400.912825193976,732,68,664,40446.174863387976,35000.0,41003.9156626506,3780,2482,1298,31938.88888888889,36720.789685737305,22795.06933744222,651,422,229,36056.52841781874,37606.635071090044,33200.0
32,NYC-Brooklyn Community District 1--Greenpoint & Williamsburg PUMA,1885,1440,445,93768.80636604775,91713.19444444444,100420.67415730337,831,611,220,149398.31528279182,140548.28150572832,173977.27272727274,954,729,225,53673.165618448635,61443.07270233196,28498.666666666668,100,100,0,14000.0,14000.0,0.0
33,Suffolk County (Central)--Brookhaven Town (Central) PUMA,4455,3135,1320,38259.83569023569,32181.690590111644,52695.430303030305,367,108,259,58414.1689373297,75200.0,51414.67181467181,2009,1197,812,51410.98456943753,42183.291562238934,65013.87684729064,2079,1830,249,21993.698893698893,23100.87431693989,13856.626506024097
34,St. Lawrence County PUMA,215,140,75,86706.97674418605,92400.0,76080.0,159,84,75,99283.01886792453,120000.0,76080.0,56,56,0,51000.0,51000.0,0.0,0,0,0,#DIV/0!,0.0,0.0
35,Genesee & Orleans Counties PUMA,160,160,0,30000.0,30000.0,0.0,0,0,0,#DIV/0!,0.0,0.0,0,0,0,#DIV/0!,0.0,0.0,160,160,0,30000.0,30000.0,0.0
36,Monroe County (Central)--Rochester City (West) PUMA,282,0,282,28057.44680851064,0.0,28057.44680851064,0,0,0,#DIV/0!,0.0,0.0,282,0,282,28057.44680851064,0.0,28057.44680851064,0,0,0,#DIV/0!,0.0,0.0
37,Wayne & Seneca Counties PUMA,749,312,437,42550.066755674234,36262.820512820515,47038.901601830665,307,25,282,74156.35179153095,200000.0,63000.0,442,287,155,20597.285067873305,22000.0,18000.0,0,0,0,#DIV/0!,0.0,0.0
38,Warren & Washington Counties PUMA,0,0,0,#DIV/0!,0.0,0.0,0,0,0,#DIV/0!,0.0,0.0,0,0,0,#DIV/0!,0.0,0.0,0,0,0,#DIV/0!,0.0,0.0
39,Erie County (North Central) PUMA,199,102,97,63253.26633165829,72052.94117647059,54000.0,199,102,97,63253.26633165829,72052.94117647059,54000.0,0,0,0,#DIV/0!,0.0,0.0,0,0,0,#DIV/0!,0.0,0.0
40,"Clinton, Franklin, Essex & Hamilton Counties PUMA",230,224,6,6360.869565217391,5191.964285714285,50000.0,6,0,6,50000.0,0.0,50000.0,224,224,0,5191.964285714285,5191.964285714285,0.0,0,0,0,#DIV/0!,0.0,0.0
41,Dutchess County (North & East) PUMA,778,715,63,33105.39845758355,29854.545454545456,70000.0,63,0,63,70000.0,0.0,70000.0,60,60,0,47500.0,47500.0,0.0,655,655,0,28238.1679389313,28238.1679389313,0.0
42,Tompkins County PUMA,771,507,264,44604.72114137484,47002.445759368835,40000.0,507,507,0,47002.445759368835,47002.445759368835,0.0,264,0,264,40000.0,0.0,40000.0,0,0,0,#DIV/0!,0.0,0.0
43,"NYC-Manhattan Community District 4 & 5--Chelsea, Clinton & Midtown Business District PUMA",2369,1724,645,100192.73533136344,105707.88283062645,85451.47286821705,1447,1159,288,139372.90255701452,138137.52372735116,144344.44444444444,645,288,357,39555.03875968992,41555.555555555555,37941.17647058824,277,277,0,36718.41155234657,36718.41155234657,0.0
44,Onondaga County (Central)--Syracuse City PUMA,1369,947,422,25489.335281227173,24841.92185850053,26942.18009478673,717,534,183,30083.82147838215,34295.13108614232,17795.081967213115,652,413,239,20436.80981595092,12619.12832929782,33946.02510460251,0,0,0,#DIV/0!,0.0,0.0
45,Suffolk County (South Central)--Brookhaven Town (South) PUMA,2019,1670,349,65519.41555225359,62117.18562874252,81799.42693409743,364,140,224,84354.3956043956,54714.28571428572,102879.46428571429,1576,1451,125,64333.18527918782,66082.7705031013,44024.0,79,79,0,2400.0,2400.0,0.0
46,Suffolk County (Northwest)--Smithtown Town PUMA,515,409,106,44619.41747572816,51000.0,20000.0,106,0,106,20000.0,0.0,20000.0,409,409,0,51000.0,51000.0,0.0,0,0,0,#DIV/0!,0.0,0.0
47,Herkimer (North & Central) & Oneida (Outer) Counties PUMA,0,0,0,#DIV/0!,0.0,0.0,0,0,0,#DIV/0!,0.0,0.0,0,0,0,#DIV/0!,0.0,0.0,0,0,0,#DIV/0!,0.0,0.0
48,NYC-Queens Community District 2--Sunnyside & Woodside PUMA,5320,3230,2090,40245.17857142857,39498.14241486068,41399.688995215314,1245,612,633,58360.642570281125,58676.470588235294,58055.292259083726,3641,2336,1305,34021.79346333425,33020.97602739726,35813.295019157085,434,282,152,40488.47926267281,51531.914893617024,20000.0
49,Onondaga County (Central)--Syracuse City (Outer) PUMA,68,68,0,45000.0,45000.0,0.0,0,0,0,#DIV/0!,0.0,0.0,0,0,0,#DIV/0!,0.0,0.0,68,68,0,45000.0,45000.0,0.0
50,Broome County (West Central)--Greater Binghamton City & Greater Johnson City Village PUMA,0,0,0,#DIV/0!,0.0,0.0,0,0,0,#DIV/0!,0.0,0.0,0,0,0,#DIV/0!,0.0,0.0,0,0,0,#DIV/0!,0.0,0.0
51,Erie County (West Central)--Buffalo City (West) PUMA,138,65,73,32471.014492753624,18400.0,45000.0,65,65,0,18400.0,18400.0,0.0,73,0,73,45000.0,0.0,45000.0,0,0,0,#DIV/0!,0.0,0.0
52,"Steuben (North & West), Schuyler & Chemung (North) Counties PUMA",0,0,0,#DIV/0!,0.0,0.0,0,0,0,#DIV/0!,0.0,0.0,0,0,0,#DIV/0!,0.0,0.0,0,0,0,#DIV/0!,0.0,0.0
53,Monroe County (North & West) PUMA,84,0,84,26020.0,0.0,26020.0,0,0,0,#DIV/0!,0.0,0.0,84,0,84,26020.0,0.0,26020.0,0,0,0,#DIV/0!,0.0,0.0
54,NYC-Brooklyn Community District 8--Crown Heights North & Prospect Heights PUMA,1894,672,1222,53942.02745512144,37471.72619047619,62999.34533551555,643,178,465,107947.12286158631,115000.0,105247.31182795699,1033,276,757,29599.419167473377,9170.289855072464,37047.82034346103,218,218,0,10000.0,10000.0,0.0
55,Cattaraugus & Allegany Counties PUMA,0,0,0,#DIV/0!,0.0,0.0,0,0,0,#DIV/0!,0.0,0.0,0,0,0,#DIV/0!,0.0,0.0,0,0,0,#DIV/0!,0.0,0.0
56,"NYC-Queens Community District 11--Bayside, Douglaston & Little Neck PUMA",2351,1442,909,56928.45597618035,46692.64909847434,73166.11661166117,1460,610,850,61689.72602739726,41716.39344262295,76023.5294117647,891,832,59,49126.599326599324,50341.105769230766,32000.0,0,0,0,#DIV/0!,0.0,0.0
57,Chemung (South) & Steuben (East) Counties--Greater Elmira & Greater Corning Cities PUMA,301,195,106,59098.67109634551,80352.30769230769,20000.0,0,0,0,#DIV/0!,0.0,0.0,301,195,106,59098.67109634551,80352.30769230769,20000.0,0,0,0,#DIV/0!,0.0,0.0
58,Suffolk County (Southwest)--Babylon Town (Southeast) PUMA,2947,978,1969,47136.54563963353,51608.38445807771,44915.388522092435,226,84,142,98132.74336283185,102000.0,95845.07042253521,2302,894,1408,40500.173761946135,46873.60178970917,36453.40909090909,419,0,419,56090.692124105015,0.0,56090.692124105015
59,Jefferson & Lewis Counties PUMA,219,177,42,32573.059360730593,30471.751412429378,41428.57142857143,24,0,24,50000.0,0.0,50000.0,34,16,18,167411.76470588235,322000.0,30000.0,161,161,0,1500.0,1500.0,0.0
60,NYC-Brooklyn Community District 3--Bedford-Stuyvesant PUMA,2870,1383,1487,38954.28571428572,43540.27476500362,34689.038332212505,1004,594,410,42892.828685258966,50698.6531986532,31583.90243902439,1242,245,997,35149.91948470209,23114.285714285714,38107.52256770311,624,544,80,40189.42307692308,44923.16176470588,8000.0
61,Schenectady County--Schenectady City PUMA,0,0,0,#DIV/0!,0.0,0.0,0,0,0,#DIV/0!,0.0,0.0,0,0,0,#DIV/0!,0.0,0.0,0,0,0,#DIV/0!,0.0,0.0
62,NYC-Queens Community District 1--Astoria & Long Island City PUMA,5857,3989,1868,49390.6590404644,53310.85234394585,41019.32548179872,2001,1182,819,80397.84607696152,93863.61252115059,60963.73626373626,2824,1863,961,34201.4164305949,37987.117552334945,26862.434963579606,1032,944,88,30833.527131782947,32775.63559322034,10000.0
63,Suffolk County (North Central)--Brookhaven Town (North) PUMA,151,78,73,151470.19867549668,209000.0,90000.0,151,78,73,151470.19867549668,209000.0,90000.0,0,0,0,#DIV/0!,0.0,0.0,0,0,0,#DIV/0!,0.0,0.0
64,Fulton & Montgomery Counties PUMA,62,62,0,10000.0,10000.0,0.0,62,62,0,10000.0,10000.0,0.0,0,0,0,#DIV/0!,0.0,0.0,0,0,0,#DIV/0!,0.0,0.0
65,NYC-Brooklyn Community District 16--Brownsville & Ocean Hill PUMA,1784,886,898,27357.79147982063,27472.009029345372,27245.10022271715,145,108,37,27391.724137931036,24100.0,37000.0,1245,541,704,29955.100401606425,28563.7707948244,31024.289772727272,394,237,157,19138.071065989847,26516.45569620253,8000.0
66,"Rockland County (South)--Orangetown, Clarkstown (South) & Ramapo (Southeast) Towns PUMA",743,401,342,107912.51682368775,82693.26683291771,137482.45614035087,342,0,342,137482.45614035087,0.0,137482.45614035087,401,401,0,82693.26683291771,82693.26683291771,0.0,0,0,0,#DIV/0!,0.0,0.0
67,Oswego County PUMA,162,0,162,50000.0,0.0,50000.0,0,0,0,#DIV/0!,0.0,0.0,162,0,162,50000.0,0.0,50000.0,0,0,0,#DIV/0!,0.0,0.0
68,"NYC-Manhattan Community District 12--Washington Heights, Inwood & Marble Hill PUMA",14479,8413,6066,55979.48753366945,64839.676690835615,43691.19683481701,5032,3035,1997,90448.1319554849,116147.9406919275,51390.085127691535,8321,4252,4069,40014.012738853504,40110.95954844779,39912.70582452691,1126,1126,0,19924.86678507993,19924.86678507993,0.0
69,Monroe County (Central)--Rochester City (East) PUMA,765,502,263,95021.43790849674,56299.6015936255,168931.55893536122,0,0,0,#DIV/0!,0.0,0.0,650,387,263,100863.69230769231,54605.684754521964,168931.55893536122,115,115,0,62000.0,62000.0,0.0
70,Westchester County (Northeast) PUMA,3955,3008,947,33455.06953223767,37106.3164893617,21857.444561774024,378,193,185,62233.862433862436,83292.22797927461,40264.86486486487,1400,1036,364,40146.42857142857,47224.903474903476,20000.0,2177,1779,398,24154.983922829582,26203.147835862845,15000.0
71,"NYC-Bronx Community District 1 & 2--Hunts Point, Longwood & Melrose PUMA",6739,4086,2653,35028.95088292031,33959.91189427313,36675.42404824727,1383,460,923,46771.29428778019,36913.47826086957,51684.18201516793,4197,2540,1657,31430.283535858947,32839.566929133856,29270.006035003018,1159,1086,73,34048.74892148404,35329.189686924496,15000.0
72,"NYC-Queens Community District 7--Flushing, Murray Hill & Whitestone PUMA",7594,5164,2430,36914.95917829865,37646.47560030984,35360.411522633745,1418,933,485,65837.51763046545,69009.21757770632,59736.0824742268,4991,3605,1386,30516.589861751152,30366.934812760057,30905.844155844155,1185,626,559,29254.261603375526,32824.281150159746,25256.350626118066
73,Onondaga County (North) PUMA,0,0,0,#DIV/0!,0.0,0.0,0,0,0,#DIV/0!,0.0,0.0,0,0,0,#DIV/0!,0.0,0.0,0,0,0,#DIV/0!,0.0,0.0
74,Suffolk County (Central)--Brookhaven Town (West Central) PUMA,2222,1719,503,48472.547254725476,46397.905759162306,55562.62425447316,193,127,66,78678.75647668394,65000.0,105000.0,1795,1358,437,43070.19498607242,41452.87187039764,48096.109839816934,234,234,0,65000.0,65000.0,0.0
75,Monroe County (South) PUMA,463,216,247,57977.02807775378,55481.48148148148,60159.36842105263,335,88,247,73251.8328358209,110000.0,60159.36842105263,128,128,0,18000.0,18000.0,0.0,0,0,0,#DIV/0!,0.0,0.0
76,"NYC-Brooklyn Community District 15--Sheepshead Bay, Gerritsen Beach & Homecrest PUMA",1467,967,500,45777.64144512611,52508.37642192347,32760.4,380,380,0,77841.05263157895,77841.05263157895,0.0,405,127,278,28342.222222222223,10000.0,36721.58273381295,682,460,222,38266.275659824045,43317.391304347824,27800.0
77,Rensselaer County--Troy City PUMA,589,429,160,32728.35314091681,37102.5641025641,21000.0,82,82,0,46000.0,46000.0,0.0,507,347,160,30581.854043392505,35000.0,21000.0,0,0,0,#DIV/0!,0.0,0.0
78,Suffolk County (Central)--Islip Town (East) PUMA,1245,699,546,42703.212851405624,60839.77110157368,19484.432234432235,699,699,0,60839.77110157368,60839.77110157368,0.0,546,0,546,19484.432234432235,0.0,19484.432234432235,0,0,0,#DIV/0!,0.0,0.0
79,Nassau County (West Central)--Hempstead Town (Northwest) PUMA,3582,2047,1535,66963.95868230039,48360.77186126038,91772.24755700325,774,156,618,83933.46253229975,47016.02564102564,93252.42718446603,2495,1578,917,62321.20240480962,45786.43852978454,90774.70010905125,313,313,0,62009.58466453674,62009.58466453674,0.0
80,Ontario & Yates Counties PUMA,0,0,0,#DIV/0!,0.0,0.0,0,0,0,#DIV/0!,0.0,0.0,0,0,0,#DIV/0!,0.0,0.0,0,0,0,#DIV/0!,0.0,0.0
81,Suffolk County (West Central)--Babylon Town (Northwest) PUMA,2762,1721,1041,63887.72628530051,81927.94886693783,34063.30451488953,371,191,180,67300.26954177898,74447.12041884816,59716.666666666664,1306,727,579,73743.87442572741,105637.68913342504,33697.582037996544,1085,803,282,50857.142857142855,62241.59402241594,18439.71631205674
82,Nassau County (Southwest)--Hempstead Town (Southwest) & Long Beach City PUMA,2876,1981,895,37665.368567454796,41391.82231196365,29417.206703910615,306,237,69,45656.86274509804,47553.5864978903,39142.02898550725,1860,1643,217,40013.978494623654,42678.63664029215,19838.709677419356,710,101,609,28068.450704225354,6000.0,31728.407224958948
83,"NYC-Bronx Community District 8--Riverdale, Fieldston & Kingsbridge PUMA",7883,5327,2556,46408.98135227705,47414.56729866717,44313.22378716745,2488,1377,1111,72612.29903536977,91533.76906318082,49160.57605760576,4117,2672,1445,38794.802040320625,37825.973053892216,40586.29757785467,1278,1278,0,19925.195618153364,19925.195618153364,0.0
84,"Rockland County (West)--Spring Valley, Suffern Villages & Monsey PUMA",3257,2020,1237,29155.449800429844,29686.633663366338,28288.035569927244,225,120,105,33188.0,27000.0,40260.0,1750,913,837,34107.42857142857,38141.29244249726,29707.287933094383,1282,987,295,21687.98751950078,22192.502532928065,20000.0
85,Chautauqua County PUMA,0,0,0,#DIV/0!,0.0,0.0,0,0,0,#DIV/0!,0.0,0.0,0,0,0,#DIV/0!,0.0,0.0,0,0,0,#DIV/0!,0.0,0.0
86,Orange County (Southeast) PUMA,1604,904,700,86078.6783042394,123302.21238938053,38007.142857142855,735,336,399,118614.96598639456,203339.2857142857,47268.17042606516,543,397,146,41906.0773480663,44445.84382871536,35000.0,326,171,155,86298.15950920245,149112.28070175438,17000.0
87,Monroe County (East) PUMA,136,136,0,81000.0,81000.0,0.0,136,136,0,81000.0,81000.0,0.0,0,0,0,#DIV/0!,0.0,0.0,0,0,0,#DIV/0!,0.0,0.0
88,Broome (Outer West) & Tioga Counties PUMA,0,0,0,#DIV/0!,0.0,0.0,0,0,0,#DIV/0!,0.0,0.0,0,0,0,#DIV/0!,0.0,0.0,0,0,0,#DIV/0!,0.0,0.0
89,Suffolk County (East) PUMA,5152,3435,1717,33389.34394409938,33238.224163027655,33691.67152009319,68,0,68,95000.0,0.0,95000.0,4023,2744,1279,31520.681083768333,34496.75655976676,25135.731039874903,1061,691,370,36526.10744580584,28240.520984081042,52000.0
90,"NYC-Queens Community District 14--Far Rockaway, Breezy Point & Broad Channel PUMA",2017,1122,895,47214.08031730293,48121.92513368984,46075.977653631286,217,86,131,76188.9400921659,78000.0,75000.0,1026,458,568,42514.619883040934,43770.742358078605,41501.76056338028,774,578,196,45320.15503875969,47124.221453287195,40000.0
91,NYC-Brooklyn Community District 14--Flatbush & Midwood PUMA,2228,966,1262,35448.11490125673,36657.76397515528,34522.187004754356,83,0,83,75000.0,0.0,75000.0,1001,565,436,36960.03996003996,48341.592920353985,22211.009174311926,1144,401,743,31255.594405594406,20195.511221945137,37224.76446837147
92,Albany County (Outside Albany City) PUMA,336,272,64,26104.761904761905,28717.647058823528,15000.0,21,21,0,113000.0,113000.0,0.0,154,90,64,17606.493506493505,19460.0,15000.0,161,161,0,22899.378881987577,22899.378881987577,0.0
93,"NYC-Bronx Community District 5--Morris Heights, Fordham South & Mount Hope PUMA",8119,3999,4120,34811.93496736051,38019.07976994249,31698.980582524273,1891,724,1167,42744.79111581174,60151.93370165746,31945.501285347043,4922,2528,2394,34425.55871596912,36558.662974683546,32173.057644110275,1306,747,559,24781.85298621746,21510.04016064257,29154.02504472272
94,"NYC-Manhattan Community District 9--Hamilton Heights, Manhattanville & West Harlem PUMA",4315,2876,1439,54666.67439165701,64555.00695410292,34903.75260597637,2179,1081,1098,72062.73519963287,112027.93709528215,32716.302367941713,1563,1222,341,36120.28150991683,34494.27168576105,41947.21407624633,573,573,0,39102.96684118674,39102.96684118674,0.0
95,Nassau County (West Central)--Hempstead Town (West Central) PUMA,4610,2419,2191,68334.96746203904,84702.43902439025,50264.26289365587,1727,1144,583,88517.66068326579,97963.28671328671,69982.84734133791,2883,1275,1608,56244.953173777314,72804.07843137255,43115.04975124378,0,0,0,#DIV/0!,0.0,0.0
96,Erie County (West Central)--Buffalo City (East) PUMA,81,81,0,22000.0,22000.0,0.0,0,0,0,#DIV/0!,0.0,0.0,0,0,0,#DIV/0!,0.0,0.0,81,81,0,22000.0,22000.0,0.0
97,NYC-Queens Community District 6--Forest Hills & Rego Park PUMA,3507,2000,1507,77711.43427430853,83704.6,69757.66423357664,1848,948,900,108088.14935064936,113940.61181434599,101923.55555555556,1576,969,607,44868.08375634518,59152.21878224974,22065.238879736407,83,83,0,25000.0,25000.0,0.0
98,"NYC-Queens Community District 13--Queens Village, Cambria Heights & Rosedale PUMA",3880,2112,1768,53406.98453608248,53656.25,53109.219457013576,1248,475,773,76014.82371794872,80031.57894736843,73546.57179818887,2448,1481,967,42272.467320261436,45203.91627278866,37782.8335056877,184,156,28,48204.34782608696,53589.743589743586,18200.0
99,"NYC-Bronx Community District 11--Pelham Parkway, Morris Park & Laconia PUMA",4652,3772,880,54241.78847807395,58057.741251325555,37885.22727272727,1220,735,485,66393.44262295082,76711.56462585034,50756.701030927834,1924,1760,164,42478.06652806653,42845.34090909091,38536.58536585366,1508,1277,231,59419.76127320955,68287.3923257635,10398.268398268398
100,Madison & Cortland Counties PUMA,0,0,0,#DIV/0!,0.0,0.0,0,0,0,#DIV/0!,0.0,0.0,0,0,0,#DIV/0!,0.0,0.0,0,0,0,#DIV/0!,0.0,0.0
101,Nassau County (Central)--Hempstead Town (East Central) PUMA,1189,491,698,82835.15559293523,129875.76374745417,49744.985673352436,735,491,244,106346.9387755102,129875.76374745417,59000.0,454,0,454,44770.92511013216,0.0,44770.92511013216,0,0,0,#DIV/0!,0.0,0.0
102,Nassau County (West Central)--North Hempstead Town (South) PUMA,3651,2123,1528,56878.663379895916,64733.30193122939,45965.44502617801,1558,803,755,74279.20410783055,95663.76089663761,51535.09933774835,1912,1139,773,44363.17991631799,46967.69095697981,40525.4851228978,181,181,0,39307.18232044199,39307.18232044199,0.0
103,Westchester County (Central)--White Plains City PUMA,5725,3213,2512,41731.89519650655,48000.21786492375,33714.331210191085,1965,1009,956,62464.580152671755,69053.51833498513,55510.355648535566,2620,1248,1372,25792.442748091602,31168.028846153848,20902.696793002917,1140,956,184,42628.070175438595,47753.13807531381,16000.0
104,"NYC-Staten Island Community District 3--Tottenville, Great Kills & Annadale PUMA",1229,953,276,70944.14971521562,72515.59286463799,65518.115942028984,675,532,143,76555.55555555556,74586.46616541353,83881.11888111888,554,421,133,64107.148014440434,69898.71733966746,45774.436090225565,0,0,0,#DIV/0!,0.0,0.0
105,Suffolk County (Northwest)--Huntington Town (South) PUMA,279,279,0,65268.81720430108,65268.81720430108,0.0,0,0,0,#DIV/0!,0.0,0.0,279,279,0,65268.81720430108,65268.81720430108,0.0,0,0,0,#DIV/0!,0.0,0.0
106,NYC-Manhattan Community District 3--Chinatown & Lower East Side PUMA,2377,1920,457,22272.40218763147,20368.28125,30272.210065645515,368,118,250,39076.086956521736,55000.0,31560.0,1927,1802,125,19789.880643487286,18100.499445061043,44144.0,82,0,82,5200.0,0.0,5200.0
107,NYC-Brooklyn Community District 13--Brighton Beach & Coney Island PUMA,541,316,225,34659.88909426987,31227.848101265823,39480.0,156,0,156,45000.0,0.0,45000.0,156,156,0,50205.1282051282,50205.1282051282,0.0,229,160,69,17026.200873362446,12725.0,27000.0
108,NYC-Brooklyn Community District 7--Sunset Park & Windsor Terrace PUMA,4695,3101,1594,31668.21299254526,35524.250241857466,24166.599749058973,1006,770,236,33600.39761431411,33698.7012987013,33279.661016949154,1728,733,995,29509.46759259259,35871.487039563435,24822.67336683417,1961,1598,363,32579.245283018867,36244.61827284105,16443.526170798898
109,Suffolk County (Northwest)--Huntington Town (North) PUMA,2411,1729,682,58938.61468270427,59839.21341816078,56655.425219941346,804,396,408,109034.32835820895,143555.55555555556,75528.43137254902,213,140,73,26706.103286384976,35000.0,10800.0,1394,1193,201,34970.58823529412,34965.632858340316,35000.0
110,Suffolk County (Southwest)--Islip Town (South) PUMA,1558,1295,263,64722.72143774069,64540.54054054054,65619.77186311787,776,657,119,65981.9587628866,62356.16438356164,86000.0,782,638,144,63473.14578005115,66789.96865203761,48777.77777777778,0,0,0,#DIV/0!,0.0,0.0
111,"NYC-Brooklyn Community District 17--East Flatbush, Farragut & Rugby PUMA",1925,1102,823,52015.168831168834,44180.76225045372,62505.46780072904,804,148,656,64741.293532338306,50000.0,68067.0731707317,785,618,167,50377.07006369427,53003.23624595469,40658.68263473054,336,336,0,25390.47619047619,25390.47619047619,0.0
112,Ulster County (East) PUMA,561,302,259,33583.31550802139,17271.655629139073,52603.0888030888,72,0,72,60000.0,0.0,60000.0,489,302,187,29693.742331288344,17271.655629139073,49755.08021390374,0,0,0,#DIV/0!,0.0,0.0
113,NYC-Manhattan Community District 10--Central Harlem PUMA,2991,1331,1660,34704.76763624206,44917.09992486852,26516.44578313253,969,321,648,41353.97316821465,71716.5109034268,26313.271604938273,2022,1010,1012,31518.27893175074,36399.66336633663,26646.541501976284,0,0,0,#DIV/0!,0.0,0.0
114,NYC-Brooklyn Community District 4--Bushwick PUMA,7867,5822,2045,40372.604550654636,42839.02095499828,33350.855745721274,2382,1683,699,45393.24097397145,41515.74569221628,54729.18454935622,3820,2860,960,39873.92146596859,45120.76223776224,24242.708333333332,1665,1279,386,34334.05405405405,39478.0297107115,17289.63730569948
115,"NYC-Brooklyn Community District 9--Crown Heights South, Prospect Lefferts & Wingate PUMA",524,524,0,54982.82442748092,54982.82442748092,0.0,0,0,0,#DIV/0!,0.0,0.0,524,524,0,54982.82442748092,54982.82442748092,0.0,0,0,0,#DIV/0!,0.0,0.0
116,Oneida County (Central)--Greater Utica & Rome Cities PUMA,537,398,139,28317.31843575419,32797.98994974874,15487.769784172662,97,26,71,28020.618556701033,39000.0,24000.0,347,279,68,30361.383285302592,36152.68817204301,6600.0,93,93,0,21000.0,21000.0,0.0
117,"NYC-Bronx Community District 9--Castle Hill, Clason Point & Parkchester PUMA",7869,5209,2660,38034.50247807854,37746.304473027456,38598.87218045113,1186,742,444,54159.612141652615,39357.54716981132,78896.39639639639,5888,3915,1973,35401.66440217391,39389.272030651344,27489.102889001522,795,552,243,33478.23899371069,23927.898550724636,55172.83950617284
118,Erie County (Central) PUMA,0,0,0,#DIV/0!,0.0,0.0,0,0,0,#DIV/0!,0.0,0.0,0,0,0,#DIV/0!,0.0,0.0,0,0,0,#DIV/0!,0.0,0.0
119,Livingston & Wyoming Counties PUMA,95,95,0,37684.21052631579,37684.21052631579,0.0,0,0,0,#DIV/0!,0.0,0.0,17,17,0,50000.0,50000.0,0.0,78,78,0,35000.0,35000.0,0.0
120,Nassau County (East Central)--Oyster Bay Town (Central) PUMA,1132,666,466,61035.86572438163,58957.95795795796,64005.57939914163,246,0,246,95941.46341463414,0.0,95941.46341463414,574,354,220,55300.6968641115,72083.61581920904,28295.454545454544,312,312,0,44065.38461538462,44065.38461538462,0.0
121,Niagara County (North & East) PUMA,86,86,0,7000.0,7000.0,0.0,86,86,0,7000.0,7000.0,0.0,0,0,0,#DIV/0!,0.0,0.0,0,0,0,#DIV/0!,0.0,0.0
122,Westchester County (Southwest)--Yonkers City PUMA,10030,6141,3889,43457.6370887338,48346.66992346523,35737.5160709694,2601,1657,944,65600.23068050749,64382.257091128544,67738.13559322034,5327,2711,2616,32707.508916838746,39426.22648469199,25744.80122324159,2102,1773,329,43302.09324452902,47000.0,23373.86018237082
123,Sullivan & Ulster (West) Counties PUMA,115,88,27,45800.0,52181.818181818184,25000.0,91,64,27,53131.868131868134,65000.0,25000.0,24,24,0,18000.0,18000.0,0.0,0,0,0,#DIV/0!,0.0,0.0
124,"NYC-Brooklyn Community District 12--Borough Park, Kensington & Ocean Parkway PUMA",1660,1487,173,33853.614457831325,34110.2891728312,31647.398843930634,248,133,115,57153.22580645161,76308.27067669173,35000.0,1039,981,58,29265.640038498557,29517.838939857287,25000.0,373,373,0,31142.091152815014,31142.091152815014,0.0
125,NYC-Brooklyn Community District 11--Bensonhurst & Bath Beach PUMA,2663,2063,600,32793.052947803226,30894.28017450315,39321.666666666664,505,403,102,42691.08910891089,36719.60297766749,66284.3137254902,1712,1214,498,29953.6214953271,28376.112026359144,33799.1967871486,446,446,0,32484.977578475336,32484.977578475336,0.0
126,"NYC-Bronx Community District 7--Bedford Park, Fordham North & Norwood PUMA",9347,6336,3011,37788.15662779501,39687.72095959596,33790.93324476918,1242,255,987,53561.59420289855,75325.49019607843,47938.7031408308,6917,5261,1656,35305.247939858324,39454.7424444022,22122.584541062803,1188,820,368,35754.208754208754,30100.0,48353.260869565216
127,NYC-Manhattan Community District 11--East Harlem PUMA,3102,1671,1431,51911.592520954226,42215.296229802516,63234.10202655486,1177,68,1109,76486.96686491079,110120.0,74424.70694319207,1744,1603,141,38741.74311926605,39334.74734872115,32000.0,181,0,181,19000.0,0.0,19000.0
128,Westchester County (Southeast) PUMA,5825,4075,1750,39140.24034334764,36102.74846625767,46213.25714285715,208,107,101,134153.84615384616,72000.0,200000.0,2552,1447,1105,34305.09404388715,36540.15203870076,31378.280542986424,3065,2521,544,36718.20554649266,34328.084093613645,47794.48529411765
129,Niagara County (Southwest)--Greater Niagara Falls & North Tonawanda Area PUMA,0,0,0,#DIV/0!,0.0,0.0,0,0,0,#DIV/0!,0.0,0.0,0,0,0,#DIV/0!,0.0,0.0,0,0,0,#DIV/0!,0.0,0.0
130,Erie County (Northeast) PUMA,424,424,0,190422.64150943398,190422.64150943398,0.0,298,298,0,242185.23489932885,242185.23489932885,0.0,126,126,0,68000.0,68000.0,0.0,0,0,0,#DIV/0!,0.0,0.0
131,Monroe County (Central)--Greece & Gates Towns PUMA,315,255,60,46460.31746031746,51509.80392156863,25000.0,0,0,0,#DIV/0!,0.0,0.0,315,255,60,46460.31746031746,51509.80392156863,25000.0,0,0,0,#DIV/0!,0.0,0.0
132,NYC-Brooklyn Community District 10--Bay Ridge & Dyker Heights PUMA,1399,957,442,38067.655468191566,40972.57053291536,31778.054298642535,241,241,0,60705.39419087137,60705.39419087137,0.0,841,477,364,28361.177170035673,24857.96645702306,32951.92307692308,317,239,78,46608.51735015773,53236.40167364017,26300.0
133,"NYC-Bronx Community District 10--Co-op City, Pelham Bay & Schuylerville PUMA",2556,1680,876,49266.353677621286,59628.869047619046,29393.036529680365,79,43,36,25405.063291139242,45000.0,2000.0,2477,1637,840,50027.37182075091,60013.13378130727,30567.02380952381,0,0,0,#DIV/0!,0.0,0.0
134,"NYC-Manhattan Community District 1 & 2--Battery Park City, Greenwich Village & Soho PUMA",1298,743,555,120510.36363636363,165588.29071332436,60162.7963963964,1186,631,555,125752.48903878583,183442.31378763868,60162.7963963964,112,112,0,65000.0,65000.0,0.0,0,0,0,#DIV/0!,0.0,0.0
135,Albany County (East Central)--Albany City PUMA,286,190,96,22368.53146853147,32811.57894736842,1700.0,165,69,96,15625.454545454546,35000.0,1700.0,121,121,0,31563.636363636364,31563.636363636364,0.0,0,0,0,#DIV/0!,0.0,0.0
136,"NYC-Queens Community District 8--Briarwood, Fresh Meadows & Hillcrest PUMA",3706,2383,1323,41077.630868861306,34850.06294586656,52294.78458049887,1403,810,593,60901.639344262294,56837.03703703704,66453.62563237773,2303,1573,730,29000.73816760747,23528.099173553717,40793.150684931505,0,0,0,#DIV/0!,0.0,0.0
137,NYC-Queens Community District 4--Elmhurst & South Corona PUMA,13549,9483,4066,30751.80456122223,32351.78740904777,27020.216428922773,1422,75,1347,36691.63150492265,51500.0,35867.11210096511,10134,7566,2568,30416.69626998224,33004.44091990484,22792.52336448598,1993,1842,151,28217.7119919719,28891.368078175896,20000.0
138,Nassau County (Central)--Hempstead Town (North Central)--Meadowbrook Corridor PUMA,5203,3682,1521,35961.233903517204,38955.13307984791,28713.675213675215,533,388,145,44127.57973733584,47835.051546391755,34206.89655172414,2180,1433,747,32696.559633027522,31843.68457780879,34332.66398929049,2490,1861,629,37071.40562248996,42579.68833960236,20774.244833068362
139,"NYC-Brooklyn Community District 6--Park Slope, Carroll Gardens & Red Hook PUMA",2004,994,1010,61431.35728542914,69920.523138833,53076.67326732673,1164,778,386,75563.14432989691,65615.68123393317,95612.69430051814,603,176,427,49010.348258706465,100000.0,27993.53629976581,237,40,197,23627.426160337553,21300.0,24100.0
140,"NYC-Bronx Community District 4--Concourse, Highbridge & Mount Eden PUMA",8670,5672,2998,39893.96078431373,40144.94005641749,39419.126084056035,840,619,221,58425.0,64247.17285945073,42117.64705882353,6869,4505,2364,39259.237152423935,37856.40399556049,41932.57191201354,961,548,413,28233.02809573361,31733.576642335767,23588.23244552058
141,NYC-Manhattan Community District 8--Upper East Side PUMA,5233,3136,2097,96554.18861073954,115799.48979591837,67773.4234620887,2837,740,2097,126774.71589707438,293971.6216216216,67773.4234620887,2396,2396,0,60771.36894824708,60771.36894824708,0.0,0,0,0,#DIV/0!,0.0,0.0
142,Orange County (Northeast)--Greater Newburgh City PUMA,3090,1627,1463,63787.3786407767,48609.711124769514,80666.43882433356,846,149,697,128187.94326241135,181000.0,116898.13486370158,1603,918,685,43429.81908920773,37271.24183006536,51683.211678832115,641,560,81,29700.46801872075,31971.428571428572,14000.0
143,"NYC-Bronx Community District 12--Wakefield, Williamsbridge & Woodlawn PUMA",1690,927,763,44310.769230769234,47361.596548004316,40604.193971166445,502,183,319,39306.17529880478,34900.0,41833.85579937304,1188,744,444,46425.50505050505,50426.74731182796,39720.72072072072,0,0,0,#DIV/0!,0.0,0.0
144,NYC-Queens Community District 10--Howard Beach & Ozone Park PUMA,2866,1927,939,52097.6622470342,51569.53814218993,53181.4696485623,692,336,356,88307.80346820809,96410.71428571429,80660.11235955056,1643,1330,313,46988.74010955569,43693.60902255639,60990.41533546326,531,261,270,20716.38418079096,33977.011494252874,7897.777777777777
145,Suffolk County (Central)--Islip Town (Northwest) PUMA,10797,7025,3772,38973.64082615542,43089.807829181496,31307.661717921528,1792,1536,256,43980.46875,43329.427083333336,47886.71875,5189,2729,2460,40963.24918095972,50975.22902161964,29856.463414634145,3816,2760,1056,33916.95492662474,35159.60144927536,30669.128787878788
146,Capital Region,1736,1315,421,#DIV/0!,218783.48128522665,140700.0,597,501,96,#DIV/0!,275370.4411764706,1700.0,909,584,325,#DIV/0!,206023.63636363635,139000.0,230,230,0,#DIV/0!,60899.37888198758,0.0
147,Central NY,1599,1015,584,#DIV/0!,69841.92185850053,76942.18009478673,717,534,183,#DIV/0!,34295.13108614232,17795.081967213115,814,413,401,#DIV/0!,12619.12832929782,83946.02510460251,68,68,0,#DIV/0!,45000.0,0.0
148,Finger Lakes,3049,1676,1373,#DIV/0!,348237.9180358119,355207.27576675516,778,249,529,#DIV/0!,391000.0,123159.36842105264,1918,1074,844,#DIV/0!,196115.4886760906,266009.00574387185,353,353,0,#DIV/0!,127000.0,0.0
149,Long Island,71014,45760,25254,1469369.1218775657,1680605.2218809759,1175156.0982422144,14844,8495,6349,#DIV/0!,1986376.409059925,1618255.0407492553,39941,24851,15090,#DIV/0!,1090455.3840431238,813128.4979803165,16229,12414,3815,#DIV/0!,669276.0882419347,258558.81578809195
150,Mid-Hudson,54489,35167,19322,834334.4161041691,855157.7634310046,786503.9487031831,12762,5780,6982,1371670.7095913352,1273342.8709791345,1224121.7844317209,25920,16279,9641,669887.871295841,711589.1903415055,428779.3838186114,15807,13108,2699,#DIV/0!,550729.2738865364,262196.44589996093
151,Mohawk Valley,659,460,199,#DIV/0!,42797.98994974874,65621.10311750599,187,88,99,#DIV/0!,49000.0,104000.0,379,279,100,#DIV/0!,36152.68817204301,30600.0,93,93,0,#DIV/0!,21000.0,0.0
152,New York City,251388,159612,91776,2963449.6612964272,2981360.2157965354,2772439.035732005,65192,33175,32017,#DIV/0!,4068192.0169229265,3410896.3825841453,148196,97890,50306,#DIV/0!,2171508.966350702,1926118.3335070107,38000,28547,9453,#DIV/0!,1383948.2262641748,738626.1030184409
153,North Country,664,541,123,125640.90567013403,128063.71569814367,167508.57142857142,189,84,105,199283.01886792452,120000.0,176080.0,314,296,18,223603.72899159664,378191.96428571426,30000.0,161,161,0,#DIV/0!,1500.0,0.0
154,Southern Tier,1215,845,370,#DIV/0!,150544.96324188632,60000.0,515,515,0,#DIV/0!,69902.44575936883,0.0,700,330,370,#DIV/0!,103559.7150997151,60000.0,0,0,0,#DIV/0!,0.0,0.0
155,Western NY,1276,973,303,#DIV/0!,344661.6291975325,124000.0,898,668,230,#DIV/0!,370638.17607579945,79000.0,297,224,73,#DIV/0!,107306.12244897959,45000.0,81,81,0,#DIV/0!,22000.0,0.0
