,puma,Total_geo,Total_geo_m,Total_geo_f,Total_Avg_PINCP_mf_t,Total_Avg_PINCP_m,Total_Avg_PINCP_f,Total_BABS,Total_BABS_m,Total_BABS_f,BABS_Avg_PINCP_mf_t,BABS_Avg_PINCP_m,BABS_Avg_PINCP_f,Total_HS,Total_HS_m,Total_HS_f,HS_Avg_PINCP_mf_t,HS_Avg_PINCP_m,HS_Avg_PINCP_f,Total_HSINC,Total_HSINC_m,Total_HSINC_f,HSINC_Avg_PINCP_mf_t,HSINC_Avg_PINCP_m,HSINC_Avg_PINCP_f
0,Total Geo,372420,232022,140398,44056.32868535524,45378.17289308772,41871.84645080414,87654,43582,44072,69329.74076482534,76794.8553760727,61947.62456888727,205865,127849,78016,38380.161688485176,40899.76580184436,34251.151404840035,78901,60591,18310,30789.176892561565,32230.31285174366,26020.205352266523
1,Westchester County (Southwest)--Yonkers City PUMA,8694,5449,3245,51187.88532321141,53151.921453477706,47889.87827426811,2495,1291,1204,83624.78356713426,88039.9535243997,78890.57724252492,4655,2870,1785,37570.062298603654,41824.50871080139,30729.579831932773,1544,1288,256,39828.367875647666,43423.05900621118,21742.578125
2,St. Lawrence County PUMA,101,56,45,73075.24752475247,82696.42857142857,61102.22222222222,49,23,26,112020.40816326531,161608.69565217392,68153.84615384616,46,27,19,38686.95652173913,29703.703703703704,51452.63157894737,6,6,0,18666.666666666668,18666.666666666668,0.0
3,"NYC-Queens Community District 7--Flushing, Murray Hill & Whitestone PUMA",7456,4465,2991,43948.36909871244,46394.732362821946,40296.40922768305,1443,536,907,58420.59598059598,69649.55223880598,51784.74090407938,4911,3149,1762,42104.21502748931,45080.37472213401,36785.300794551644,1102,780,322,33216.2613430127,35720.794871794875,27149.378881987577
4,Erie County (Central) PUMA,139,102,37,30647.48201438849,33892.1568627451,21702.702702702703,51,36,15,25976.470588235294,23050.0,33000.0,52,30,22,27646.153846153848,37653.333333333336,14000.0,36,36,0,41600.0,41600.0,0.0
5,Monroe County (South) PUMA,379,216,163,55811.044854881264,55807.916666666664,55815.19018404908,179,42,137,73938.97206703911,103333.33333333333,64927.562043795624,130,104,26,27316.153846153848,32195.19230769231,7800.0,70,70,0,62374.42857142857,62374.42857142857,0.0
6,Onondaga County (North) PUMA,254,106,148,64927.16535433071,72018.8679245283,59847.97297297297,138,17,121,65989.13043478261,75000.0,64723.14049586777,116,89,27,63663.793103448275,71449.4382022472,38000.0,0,0,0,#DIV/0!,0.0,0.0
7,"NYC-Bronx Community District 9--Castle Hill, Clason Point & Parkchester PUMA",6717,4166,2551,37283.98094387375,38834.56553048488,34751.74441395531,824,425,399,55623.179611650485,53212.94117647059,58190.47619047619,4878,2938,1940,36283.45633456334,40647.24302246426,29674.79381443299,1015,803,212,27204.23645320197,24592.403486924035,37097.16981132075
8,"Clinton, Franklin, Essex & Hamilton Counties PUMA",271,163,108,47865.64575645756,42064.41717791411,56621.2037037037,37,27,10,108394.32432432432,121500.0,73009.0,199,101,98,35180.90452261306,16000.0,54948.97959183674,35,35,0,56000.0,56000.0,0.0
9,Suffolk County (Southwest)--Babylon Town (Southeast) PUMA,2142,998,1144,41283.80018674136,44010.22044088176,38905.332167832166,118,48,70,84000.0,86416.66666666667,82342.85714285714,1480,761,719,40616.01351351351,43064.12614980289,38024.89568845619,544,189,355,33834.92647058824,37049.735449735446,32123.38028169014
10,Suffolk County (Northwest)--Smithtown Town PUMA,544,388,156,58105.14705882353,60035.051546391755,53305.1282051282,188,100,88,90496.8085106383,105398.0,73563.63636363637,296,228,68,39658.10810810811,43407.01754385965,27088.235294117647,60,60,0,47616.666666666664,47616.666666666664,0.0
11,"NYC-Bronx Community District 12--Wakefield, Williamsbridge & Woodlawn PUMA",2398,1307,1091,40387.49791492911,47585.248661055855,31764.711274060493,590,198,392,43879.15254237288,48059.09090909091,41767.857142857145,1469,815,654,39559.78216473792,49847.877300613494,26738.990825688074,339,294,45,37897.345132743365,40993.87755102041,17666.666666666668
12,Dutchess County (Southwest) PUMA,2479,1790,689,37788.42678499395,34534.8938547486,46241.00145137881,530,310,220,59470.09433962264,52746.77419354839,68943.86363636363,1324,904,420,33668.32326283988,31578.495575221237,38166.42857142857,625,576,49,28130.4,29373.26388888889,13520.408163265307
13,Ulster County (East) PUMA,730,412,318,47065.31506849315,43110.388349514564,52189.30817610063,180,58,122,84215.55555555556,95758.62068965517,78727.86885245901,422,274,148,31964.644549763034,29407.591240875914,36698.64864864865,128,80,48,44607.8125,51872.5,32500.0
14,Orange County (Northwest) PUMA,1820,1312,508,43248.79120879121,46730.18292682927,34257.48031496063,212,79,133,65951.88679245283,80567.08860759494,57270.67669172932,1281,918,363,43442.77907884465,50209.58605664488,26330.027548209368,327,315,12,27770.030581039755,28104.126984126986,19000.0
15,"NYC-Bronx Community District 11--Pelham Parkway, Morris Park & Laconia PUMA",4375,2819,1556,42154.137142857144,45676.05533877262,35773.48971722365,987,447,540,58379.28064842959,72418.34451901566,46758.055555555555,2356,1466,890,37736.54499151104,40677.96725784447,32891.4606741573,1032,906,126,36721.608527131786,40569.426048565125,9053.968253968254
16,"NYC-Manhattan Community District 1 & 2--Battery Park City, Greenwich Village & Soho PUMA",1458,935,523,127846.33058984911,148292.38502673796,91293.63288718929,1359,860,499,132400.99337748345,154793.46511627908,93808.75751503005,75,75,0,73746.66666666667,73746.66666666667,0.0,24,0,24,39000.0,0.0,39000.0
17,"NYC-Brooklyn Community District 12--Borough Park, Kensington & Ocean Parkway PUMA",1745,1273,472,39275.93123209169,36747.76119402985,46094.49152542373,352,182,170,65366.47727272727,60126.37362637363,70976.4705882353,687,504,183,33457.64192139738,33360.71428571428,33724.59016393442,706,587,119,31929.320113314447,32407.325383304942,29571.428571428572
18,"NYC-Staten Island Community District 1--Port Richmond, Stapleton & Mariner's Harbor PUMA",3998,2375,1623,40526.470735367686,38941.642105263156,42845.61306223044,611,223,388,67936.21931260229,50364.125560538116,78035.64432989691,2373,1431,942,39136.70459334176,41598.602375960865,35396.8152866242,1014,721,293,27262.721893491125,30135.367545076282,20193.856655290103
19,Monroe County (Central)--Greece & Gates Towns PUMA,346,214,132,46230.92485549133,48884.11214953271,41929.545454545456,150,103,47,54557.333333333336,48578.64077669903,67659.5744680851,161,89,72,42435.40372670807,52644.94382022472,29815.277777777777,35,22,13,28005.714285714286,35100.0,16000.0
20,Westchester County (South Central)--New Rochelle & Mount Vernon Cities PUMA,4132,2930,1202,47486.07696030978,45863.05870307167,51442.352745424294,1007,376,631,77016.00794438928,97865.9574468085,64591.94928684628,1700,1385,315,36597.64,34139.71119133574,47404.723809523806,1425,1169,256,39607.973333333335,43026.22925577417,23998.828125
21,Orange County (Northeast)--Greater Newburgh City PUMA,2651,1367,1284,45340.48283666541,43354.07461594733,47455.29595015576,350,64,286,96367.14285714286,138968.75,86833.91608391609,1609,769,840,39461.54133001865,42966.605981794535,36252.73809523809,692,534,158,33201.58959537572,32452.62172284644,35732.91139240506
22,Suffolk County (East) PUMA,4872,3476,1396,37626.648193760266,40518.01783659378,30427.220630372492,807,657,150,52377.69516728625,53476.10350076103,47566.666666666664,3090,2135,955,35166.00647249191,37808.8337236534,29257.696335078534,975,684,291,33215.661538461536,36527.73391812865,25430.584192439863
23,Tompkins County PUMA,228,165,63,48831.71052631579,51437.757575757576,42006.34920634921,132,111,21,48254.77272727273,48677.747747747744,46019.04761904762,94,52,42,50148.936170212764,58346.153846153844,40000.0,2,2,0,25000.0,25000.0,0.0
24,Monroe County (Central)--Rochester City (East) PUMA,524,299,225,50473.62595419848,42634.44816053512,60891.02222222222,77,13,64,45246.753246753244,100000.0,34125.0,336,225,111,60202.67857142857,43954.22222222222,93138.73873873874,111,61,50,24649.369369369368,25540.983606557376,23561.6
25,Ontario & Yates Counties PUMA,267,165,102,21901.87265917603,26977.575757575756,13691.176470588236,0,0,0,#DIV/0!,0.0,0.0,125,85,40,26840.0,28511.764705882353,23287.5,142,80,62,17554.929577464787,25347.5,7500.0
26,"NYC-Bronx Community District 7--Bedford Park, Fordham North & Norwood PUMA",8018,4856,3162,35407.62584185582,36429.24299835255,33838.69070208729,1411,510,901,44754.28773919206,46118.82352941176,43981.9089900111,4955,3262,1693,34450.53481331988,37060.48436541999,29421.795629060838,1652,1084,568,30295.18401937046,29970.944649446494,30913.978873239437
27,Chautauqua County PUMA,137,62,75,21478.10218978102,22120.967741935485,20946.666666666668,7,0,7,40857.142857142855,0.0,40857.142857142855,83,15,68,20632.530120481926,28500.0,18897.058823529413,47,47,0,20085.106382978724,20085.106382978724,0.0
28,Genesee & Orleans Counties PUMA,245,207,38,23067.591836734693,20762.318840579712,35625.26315789474,16,16,0,16000.0,16000.0,0.0,50,12,38,35811.2,36400.0,35625.26315789474,179,179,0,20139.664804469274,20139.664804469274,0.0
29,"NYC-Brooklyn Community District 15--Sheepshead Bay, Gerritsen Beach & Homecrest PUMA",1022,699,323,49625.53816046967,54320.02861230329,39466.25386996904,253,235,18,93790.5138339921,96761.70212765958,55000.0,461,191,270,36097.830802603035,30662.303664921466,39942.96296296296,308,273,35,33594.805194805194,34337.728937728934,27800.0
30,Broome County (West Central)--Greater Binghamton City & Greater Johnson City Village PUMA,87,41,46,29195.402298850575,36292.68292682927,22869.565217391304,12,12,0,66000.0,66000.0,0.0,75,29,46,23306.666666666668,24000.0,22869.565217391304,0,0,0,#DIV/0!,0.0,0.0
31,Westchester County (Central)--White Plains City PUMA,6010,3747,2263,45815.840266222964,44685.188150520415,47687.93636765356,1766,631,1135,73693.37485843715,84207.44849445325,67848.10572687225,2794,1912,882,36172.83464566929,39544.299163179916,28864.172335600906,1450,1204,246,30444.0,32136.04651162791,22162.60162601626
32,Nassau County (Northwest)--North Hempstead Town (North) PUMA,1548,1074,474,51093.81136950904,53403.55679702049,45860.33755274262,497,286,211,73261.36820925554,79159.79020979021,65266.35071090047,746,556,190,45395.87131367292,50271.07913669065,31129.473684210527,305,232,73,28908.196721311477,29159.48275862069,28109.58904109589
33,Cattaraugus & Allegany Counties PUMA,0,0,0,#DIV/0!,0.0,0.0,0,0,0,#DIV/0!,0.0,0.0,0,0,0,#DIV/0!,0.0,0.0,0,0,0,#DIV/0!,0.0,0.0
34,NYC-Brooklyn Community District 1--Greenpoint & Williamsburg PUMA,2629,1657,972,47713.11905667554,48645.654797827396,46123.39506172839,792,431,361,79308.20707070707,84938.5150812065,72586.14958448753,1304,921,383,38663.22085889571,40140.49945711184,35110.80939947781,533,305,228,22905.90994371482,23042.45901639344,22723.245614035088
35,Suffolk County (Northwest)--Huntington Town (North) PUMA,2680,2062,618,40204.67910447761,41223.58874878759,36805.016181229774,524,351,173,74315.07633587786,86809.11680911681,48965.89595375722,821,527,294,34883.06942752741,35653.889943074006,33501.360544217685,1335,1184,151,30088.719101123595,30188.716216216217,29304.635761589405
36,"NYC-Manhattan Community District 9--Hamilton Heights, Manhattanville & West Harlem PUMA",6285,3742,2543,37677.50198886237,41116.969535008015,32616.358631537554,1694,900,794,56668.24085005903,63587.666666666664,48825.062972292195,3019,1714,1305,35552.69956939384,40203.20886814469,29444.674329501915,1572,1128,444,21293.575063613232,24576.68439716312,12952.702702702703
37,NYC-Brooklyn Community District 10--Bay Ridge & Dyker Heights PUMA,1832,1188,644,34436.07532751092,32680.008417508416,37675.527950310556,350,156,194,50509.142857142855,61256.41025641026,41867.010309278354,1030,599,431,31094.26213592233,27355.50918196995,36290.34802784223,452,433,19,29605.309734513274,29750.346420323327,26300.0
38,"NYC-Brooklyn Community District 6--Park Slope, Carroll Gardens & Red Hook PUMA",1426,670,756,68333.73071528751,81838.20895522388,56365.47619047619,818,426,392,89940.58679706602,98867.13615023474,80239.79591836735,570,235,335,40319.12280701754,53287.234042553195,31222.089552238805,38,9,29,23436.842105263157,21300.0,24100.0
39,Livingston & Wyoming Counties PUMA,100,62,38,26495.0,35080.645161290326,12486.842105263158,0,0,0,#DIV/0!,0.0,0.0,45,9,36,15877.777777777777,33333.333333333336,11513.888888888889,55,53,2,35181.818181818184,35377.35849056604,30000.0
40,Albany County (Outside Albany City) PUMA,279,181,98,64532.47311827957,81070.49723756906,33987.755102040814,80,55,25,59928.25,65972.0,46632.0,137,94,43,85570.07299270073,109979.78723404255,32209.302325581397,62,32,30,23987.09677419355,22100.0,26000.0
41,NYC-Manhattan Community District 3--Chinatown & Lower East Side PUMA,2134,1084,1050,38161.25679475164,39465.011070110704,36815.28571428572,634,261,373,67993.92744479496,73624.52107279694,64054.02144772118,1221,741,480,25091.295659295658,26678.909581646425,22640.416666666668,279,82,197,27568.10035842294,46280.48780487805,19779.187817258884
42,Nassau County (Northeast)--Oyster Bay Town (North) & Glen Cove City PUMA,1911,1343,568,42316.32129774987,44946.45569620253,36097.535211267605,258,132,126,71527.13178294574,73757.57575757576,69190.47619047618,981,600,381,27572.731906218145,28603.75,25949.081364829395,672,611,61,52624.46428571428,54770.60556464812,31127.868852459018
43,"NYC-Queens Community District 11--Bayside, Douglaston & Little Neck PUMA",2101,1297,804,59372.20847215612,45925.20431765613,81064.70149253731,628,222,406,94423.5668789809,69126.12612612612,108256.15763546799,1247,902,345,46174.02566158781,42126.37472283814,56756.57971014493,226,173,53,34796.46017699115,35959.53757225433,31000.0
44,Erie County (South) PUMA,120,35,85,31925.0,33428.57142857143,31305.882352941175,102,17,85,31254.901960784315,31000.0,31305.882352941175,18,18,0,35722.22222222222,35722.22222222222,0.0,0,0,0,#DIV/0!,0.0,0.0
45,NYC-Manhattan Community District 7--Upper West Side & West Side PUMA,2743,1515,1228,99109.91615020052,105125.88778877888,91687.9315960912,1982,968,1014,117232.08879919273,139944.44214876034,95550.0788954635,514,359,155,61820.038910505835,50516.71309192201,88000.0,247,188,59,31291.497975708502,30127.659574468085,35000.0
46,"NYC-Queens Community District 12--Jamaica, Hollis & St. Albans PUMA",4904,2799,2105,32717.18189233279,35638.17792068596,28833.15914489311,825,281,544,43411.27272727273,54500.71174377224,37683.08823529412,2723,1584,1139,32692.72860815277,36636.42676767677,27208.25285338016,1356,934,422,26259.926253687314,28270.29978586724,21810.42654028436
47,NYC-Brooklyn Community District 3--Bedford-Stuyvesant PUMA,1730,971,759,37327.919075144506,39640.473738414,34369.43346508564,576,393,183,45857.118055555555,43346.81933842239,51248.08743169399,806,278,528,31016.129032258064,33058.27338129497,29940.909090909092,348,300,48,37829.31034482759,40884.666666666664,18733.333333333332
48,Dutchess County (North & East) PUMA,1026,776,250,36453.09941520468,36879.12371134021,35130.72,81,42,39,62987.654320987655,67504.76190476191,58123.07692307692,605,430,175,38494.21487603306,41772.558139534885,30438.85714285714,340,304,36,26499.647058823528,25726.315789473683,33030.0
49,Oneida County (Central)--Greater Utica & Rome Cities PUMA,287,184,103,28204.59930313589,33383.913043478264,18952.233009708736,54,22,32,49741.48148148148,75683.63636363637,31906.25,142,85,57,26800.563380281692,35960.0,13141.754385964912,91,77,14,17615.384615384617,18454.545454545456,13000.0
50,NYC-Brooklyn Community District 7--Sunset Park & Windsor Terrace PUMA,7103,5016,2087,34666.79431226243,36503.77392344498,30251.70579779588,1110,690,420,54384.14414414414,53870.14492753623,55228.57142857143,3023,1924,1099,32085.94442606682,36160.08316008316,24953.421292083713,2970,2402,568,29924.589225589225,31790.395503746877,22034.330985915494
51,"NYC-Bronx Community District 1 & 2--Hunts Point, Longwood & Melrose PUMA",6544,3764,2780,35573.59718826406,37890.632306057385,32436.43165467626,1500,645,855,42992.066666666666,38671.93798449612,46251.11111111111,3859,2333,1526,35225.794247214304,40430.62151735962,27268.479685452163,1185,786,399,27315.76371308017,29710.30534351145,22598.696741854637
52,Warren & Washington Counties PUMA,20,10,10,64500.0,47000.0,82000.0,10,0,10,82000.0,0.0,82000.0,0,0,0,#DIV/0!,0.0,0.0,10,10,0,47000.0,47000.0,0.0
53,Oswego County PUMA,90,66,24,41472.77777777778,37417.42424242424,52625.0,13,4,9,56384.61538461538,55000.0,57000.0,77,62,15,38955.194805194806,36283.06451612903,50000.0,0,0,0,#DIV/0!,0.0,0.0
54,Erie County (Northeast) PUMA,119,105,14,187139.49579831932,206491.42857142858,42000.0,76,76,0,259336.84210526315,259336.84210526315,0.0,43,29,14,59534.88372093023,68000.0,42000.0,0,0,0,#DIV/0!,0.0,0.0
55,Herkimer (North & Central) & Oneida (Outer) Counties PUMA,59,38,21,39813.5593220339,52815.78947368421,16285.714285714286,13,13,0,130000.0,130000.0,0.0,26,5,21,16115.384615384615,15400.0,16285.714285714286,20,20,0,12000.0,12000.0,0.0
56,Saratoga County (South & Central) PUMA,200,159,41,62348.2,63293.333333333336,58682.92682926829,90,73,17,61607.11111111111,60118.356164383564,68000.0,110,86,24,62954.545454545456,65988.37209302325,52083.333333333336,0,0,0,#DIV/0!,0.0,0.0
57,Columbia & Greene Counties PUMA,219,193,26,42489.04109589041,40093.78238341969,60269.230769230766,34,19,15,135735.29411764705,174210.52631578947,87000.0,125,122,3,24552.8,24713.93442622951,18000.0,60,52,8,27016.666666666668,27173.076923076922,26000.0
58,"NYC-Queens Community District 8--Briarwood, Fresh Meadows & Hillcrest PUMA",5073,2826,2247,43850.6031933767,45428.71549893843,41865.84779706275,1738,892,846,56216.11047180667,65994.84304932735,45905.67375886525,2748,1529,1219,38175.65866084425,36450.32701111838,40339.75389663659,587,405,182,33805.45144804088,34028.641975308645,33308.79120879121
59,NYC-Queens Community District 6--Forest Hills & Rego Park PUMA,3748,2262,1486,63068.95144076841,64623.44385499558,60702.69179004038,1646,871,775,83782.95868772782,86477.32491389208,80754.83870967742,1998,1317,681,47783.57357357357,52032.93849658314,39565.63876651983,104,74,30,28885.576923076922,31474.324324324323,22500.0
60,NYC-Queens Community District 10--Howard Beach & Ozone Park PUMA,3649,2090,1559,44773.24198410523,47298.73684210526,41387.55612572162,803,410,393,59829.115815691155,66558.73170731707,52808.396946564884,2202,1228,974,42882.552225249776,46689.39739413681,38082.956878850106,644,452,192,32464.906832298137,31483.849557522124,34774.479166666664
61,Erie County (North Central) PUMA,342,85,257,94080.40935672514,111658.82352941176,88266.53696498055,292,65,227,102440.06849315068,130630.76923076923,94367.84140969162,50,20,30,45260.0,50000.0,42100.0,0,0,0,#DIV/0!,0.0,0.0
62,NYC-Brooklyn Community District 16--Brownsville & Ocean Hill PUMA,2152,1108,1044,41128.67100371747,40352.61732851985,41952.29885057471,233,88,145,46966.95278969957,44394.318181818184,48528.275862068964,1198,517,681,42448.08013355593,49549.70986460348,37056.68135095448,721,503,218,37049.653259362,30192.44532803181,52871.55963302752
63,NYC-Staten Island Community District 2--New Springville & South Beach PUMA,1320,1025,295,36711.51515151515,35554.04878048781,40733.220338983054,203,74,129,53201.47783251232,75783.78378378379,40247.28682170543,963,843,120,35112.56490134995,33434.16370106761,46903.333333333336,154,108,46,24973.376623376622,24536.11111111111,26000.0
64,Madison & Cortland Counties PUMA,33,0,33,40090.90909090909,0.0,40090.90909090909,7,0,7,85000.0,0.0,85000.0,26,0,26,28000.0,0.0,28000.0,0,0,0,#DIV/0!,0.0,0.0
65,Westchester County (Northwest) PUMA,5307,3786,1521,33256.647823629166,31336.10670892763,38037.16633793557,998,495,503,55103.5370741483,48240.40404040404,61857.51491053678,3147,2358,789,29951.731808071178,30673.494486853266,27794.67680608365,1162,933,229,23443.71772805508,24042.2293676313,21005.24017467249
66,NYC-Brooklyn Community District 4--Bushwick PUMA,6592,4542,2050,35958.15625,36463.06164685161,34839.48292682927,1209,662,547,52993.04383788255,46521.978851963744,60824.57038391225,3592,2472,1120,33735.48886414254,36839.39158576052,26884.73214285714,1791,1408,383,28916.638749302067,31072.940340909092,20989.556135770235
67,"Rockland County (South)--Orangetown, Clarkstown (South) & Ramapo (Southeast) Towns PUMA",1243,735,508,51180.3378921963,43665.30612244898,62053.464566929135,482,119,363,76601.99170124481,69327.73109243698,78986.66666666667,499,408,91,39683.36673346694,43531.86274509804,22428.571428571428,262,208,54,26309.16030534351,29245.19230769231,15000.0
68,"NYC-Manhattan Community District 12--Washington Heights, Inwood & Marble Hill PUMA",15947,8470,7477,37455.09732238039,40389.95631641086,34130.46770094958,4075,1847,2228,55554.591411042944,66525.20844612886,46460.00897666068,9301,4769,4532,32721.57800236534,35658.18620255819,29631.400485436894,2571,1854,717,25891.901983663945,26524.80043149946,24255.36959553696
69,NYC-Brooklyn Community District 2--Brooklyn Heights & Fort Greene PUMA,1478,800,678,69625.33829499323,62211.625,78373.0825958702,657,367,290,105925.64687975647,99757.49318801089,113731.55172413793,603,332,271,46590.215588723055,32154.518072289156,64275.276752767524,218,101,117,23941.284403669724,24584.158415841583,23386.324786324785
70,"NYC-Queens Community District 14--Far Rockaway, Breezy Point & Broad Channel PUMA",1552,1019,533,43307.92525773196,45012.070657507364,40049.906191369606,252,99,153,83769.84126984127,124636.36363636363,57326.797385620914,539,299,240,40901.66975881262,47936.454849498325,32137.5,761,621,140,31613.53482260184,30910.305958132045,34732.857142857145
71,Suffolk County (Central)--Islip Town (East) PUMA,590,290,300,53172.40677966102,62769.65517241379,43895.066666666666,194,105,89,75888.24742268042,77219.04761904762,74318.20224719102,380,169,211,42761.57894736842,57368.047337278105,31062.55924170616,16,16,0,25000.0,25000.0,0.0
72,NYC-Brooklyn Community District 14--Flatbush & Midwood PUMA,2654,1586,1068,34262.58477769405,36297.604035308956,31240.54307116105,456,291,165,67655.48245614035,68628.86597938144,65938.78787878787,1368,748,620,27479.53216374269,30231.01604278075,24160.0,830,547,283,27096.385542168675,27393.418647166363,26522.26148409894
73,"NYC-Bronx Community District 4--Concourse, Highbridge & Mount Eden PUMA",7534,4249,3285,36507.649323068756,37690.63309013886,34977.51293759513,1515,691,824,49269.40594059406,56357.01881331404,43325.788834951454,4899,2902,1997,35246.15227597469,35333.94210889042,35118.5778668002,1120,656,464,24763.01785714286,28453.810975609755,19545.0
74,Erie County (West Central)--Buffalo City (East) PUMA,183,89,94,29936.06557377049,23116.85393258427,36392.55319148936,9,0,9,37100.0,0.0,37100.0,123,51,72,36043.90243902439,30223.529411764706,40166.666666666664,51,38,13,13941.176470588236,13578.947368421053,15000.0
75,Nassau County (East Central)--Oyster Bay Town (Central) PUMA,938,516,422,55426.012793176975,58005.232558139534,52272.27488151659,331,148,183,69294.56193353474,70579.72972972973,68255.1912568306,374,199,175,50781.28342245989,61618.090452261305,38458.28571428572,233,169,64,43179.82832618026,42739.05325443787,44343.75
76,Niagara County (Southwest)--Greater Niagara Falls & North Tonawanda Area PUMA,103,73,30,20407.766990291264,25054.794520547945,9100.0,30,0,30,9100.0,0.0,9100.0,60,60,0,21816.666666666668,21816.666666666668,0.0,13,13,0,40000.0,40000.0,0.0
77,"NYC-Manhattan Community District 6--Murray Hill, Gramercy & Stuyvesant Town PUMA",1917,951,966,131470.13719353155,134288.35436382756,128695.68115942029,1704,898,806,141121.50997652582,139373.3017817372,143069.26550868485,200,40,160,56811.0,58900.0,56288.75,13,13,0,15000.0,15000.0,0.0
78,Jefferson & Lewis Counties PUMA,462,368,94,37494.3722943723,40206.25,26877.659574468085,168,130,38,72244.04761904762,81346.15384615384,41105.26315789474,173,117,56,19404.046242774566,20447.863247863246,17223.214285714286,121,121,0,15111.570247933885,15111.570247933885,0.0
79,Fulton & Montgomery Counties PUMA,214,165,49,22271.40186915888,20188.363636363636,29285.714285714286,14,14,0,10000.0,10000.0,0.0,141,92,49,23539.574468085106,20479.130434782608,29285.714285714286,59,59,0,22152.542372881355,22152.542372881355,0.0
80,"NYC-Bronx Community District 8--Riverdale, Fieldston & Kingsbridge PUMA",6411,3527,2884,46077.92544064888,45913.342784235894,46279.20249653259,2014,854,1160,62137.07050645482,76297.30679156909,51712.206896551725,3321,1779,1542,43181.99939777175,42387.835862844295,44098.22308690013,1076,894,182,24957.342007434945,23904.362416107382,30129.67032967033
81,NYC-Brooklyn Community District 8--Crown Heights North & Prospect Heights PUMA,1234,390,844,60788.65478119935,75589.7435897436,53949.28909952607,578,150,428,97616.26297577855,162033.33333333334,75040.18691588785,550,152,398,31618.909090909092,26644.736842105263,33518.59296482412,106,88,18,11326.415094339623,12784.09090909091,4200.0
82,NYC-Queens Community District 3--Jackson Heights & North Corona PUMA,18737,12582,6155,35083.12958317767,36851.950564298204,31467.32038992689,2486,1387,1099,51814.019308125506,57549.179524152845,44575.923566878984,11692,7424,4268,34503.531217926786,37317.7896012931,29608.251405810683,4559,3771,788,27446.295240184252,28322.264651286132,23254.314720812185
83,Monroe County (North & West) PUMA,164,130,34,60462.256097560974,68857.92307692308,28361.176470588234,58,58,0,114509.13793103448,114509.13793103448,0.0,75,41,34,37457.066666666666,45000.0,28361.176470588234,31,31,0,15000.0,15000.0,0.0
84,NYC-Brooklyn Community District 5--East New York & Starrett City PUMA,7021,4122,2899,37698.32787352229,41099.46385249879,32862.35598482235,891,431,460,58324.208754208754,62363.1090487239,54539.934782608696,4632,2785,1847,36925.60233160622,40834.035906642726,31032.268543584192,1498,906,592,27819.55941255007,31799.889624724063,21728.04054054054
85,"Steuben (North & West), Schuyler & Chemung (North) Counties PUMA",18,18,0,34500.0,34500.0,0.0,0,0,0,#DIV/0!,0.0,0.0,18,18,0,34500.0,34500.0,0.0,0,0,0,#DIV/0!,0.0,0.0
86,NYC-Brooklyn Community District 13--Brighton Beach & Coney Island PUMA,865,544,321,43388.901734104045,47963.970588235294,35635.51401869159,158,106,52,91806.32911392405,110918.8679245283,52846.153846153844,478,299,179,35321.757322175734,39725.752508361205,27965.36312849162,229,139,90,26821.83406113537,17676.258992805757,40946.666666666664
87,NYC-Manhattan Community District 8--Upper East Side PUMA,3037,1644,1393,97335.27823510043,109140.67457420925,83402.70710696338,2239,932,1307,109956.73961589996,144724.3229613734,85164.5531752104,696,627,69,64165.51724137931,64265.07177033493,63260.86956521739,102,85,17,46616.666666666664,50000.0,29700.0
88,"Chenango, Delaware & Broome (East) Counties PUMA",134,112,22,43177.611940298506,45748.21428571428,30090.909090909092,12,12,0,120483.33333333333,120483.33333333333,0.0,104,82,22,37211.53846153846,39121.95121951219,30090.909090909092,18,18,0,26111.11111111111,26111.11111111111,0.0
89,"NYC-Queens Community District 5--Ridgewood, Glendale & Middle Village PUMA",6720,3971,2749,44310.15089285714,46059.88416016117,41782.61695161877,1228,507,721,65954.31596091205,76011.83431952662,58881.96948682386,4187,2380,1807,40658.565560066876,44053.61344537815,36186.94742667404,1305,1084,221,35658.927203065134,36455.90405904059,31749.773755656108
90,NYC-Brooklyn Community District 18--Canarsie & Flatlands PUMA,2044,1023,1021,43919.65264187867,41510.55718475073,46333.467189030365,705,246,459,56047.94326241135,63145.528455284555,52244.00871459695,1108,562,546,39562.42779783394,37548.57651245552,41635.29304029304,231,215,16,27804.329004329004,27112.558139534885,37100.0
91,Monroe County (Central)--Rochester City (West) PUMA,263,80,183,34514.828897338404,53726.25,26116.39344262295,26,26,0,92000.0,92000.0,0.0,205,54,151,29489.756097560974,35298.148148148146,27412.582781456953,32,0,32,20000.0,0.0,20000.0
92,Erie County (Northwest) PUMA,26,26,0,37800.0,37800.0,0.0,0,0,0,#DIV/0!,0.0,0.0,26,26,0,37800.0,37800.0,0.0,0,0,0,#DIV/0!,0.0,0.0
93,NYC-Queens Community District 4--Elmhurst & South Corona PUMA,12843,9765,3078,33471.62345246438,33706.40655401946,32726.770630279403,1913,1221,692,41421.79822268688,42422.850122850126,39655.491329479766,7434,5688,1746,34638.479956954536,35386.490857946555,32201.660939289806,3496,2856,640,26640.074370709382,26633.89355742297,26667.65625
94,"Otsego, Schoharie, Oneida (South) & Herkimer (South) Counties PUMA",185,85,100,32985.62162162162,23812.235294117647,40783.0,85,0,85,41509.41176470588,0.0,41509.41176470588,21,6,15,35333.333333333336,32000.0,36666.666666666664,79,79,0,23190.379746835442,23190.379746835442,0.0
95,Suffolk County (Central)--Islip Town (Northwest) PUMA,10344,6815,3529,40947.28828306265,44349.23110785033,34377.653726268065,1087,690,397,49387.3137074517,52781.463768115944,43488.161209068014,5899,3607,2292,41029.62196982539,44366.86997504852,35777.67888307155,3358,2518,840,38070.577724836214,42013.30420969023,26251.785714285714
96,Rensselaer County--Troy City PUMA,283,210,73,32364.664310954064,34356.19047619047,26635.616438356163,79,61,18,37764.556962025315,43950.81967213115,16800.0,174,119,55,30148.275862068964,30284.03361344538,29854.545454545456,30,30,0,31000.0,31000.0,0.0
97,"NYC-Queens Community District 13--Queens Village, Cambria Heights & Rosedale PUMA",2601,1559,1042,50838.51595540177,55737.331622835154,43509.09788867562,800,442,358,64776.75,69280.31674208144,59216.48044692737,1543,947,596,46802.32015554115,52989.01795142556,36972.11409395973,258,170,88,31758.13953488372,35835.294117647056,23881.81818181818
98,Erie County (West Central)--Buffalo City (West) PUMA,472,246,226,40965.042372881355,40611.78861788618,41349.55752212389,254,186,68,42929.13385826772,42758.06451612903,43397.05882352941,180,60,120,42863.88888888889,33958.333333333336,47316.666666666664,38,0,38,18842.105263157893,0.0,18842.105263157893
99,Suffolk County (Central)--Brookhaven Town (Central) PUMA,4144,2572,1572,44337.942084942086,44664.6967340591,43803.32824427481,566,244,322,60913.074204947,61100.0,60771.42857142857,2435,1487,948,49734.592197125254,53332.750504371215,44090.645569620254,1143,841,302,24633.333333333332,24570.035671819263,24809.60264900662
100,Cayuga & Onondaga (South) Counties PUMA,238,213,25,39757.98319327731,38321.126760563384,52000.0,81,56,25,42696.2962962963,38542.857142857145,52000.0,115,115,0,41982.608695652176,41982.608695652176,0.0,42,42,0,28000.0,28000.0,0.0
101,Sullivan & Ulster (West) Counties PUMA,641,433,208,38541.497659906396,37051.27020785219,41643.75,95,21,74,58631.57894736842,73000.0,54554.05405405405,351,217,134,36994.58689458689,38526.26728110599,34514.17910447761,195,195,0,31538.46153846154,31538.46153846154,0.0
102,Chemung (South) & Steuben (East) Counties--Greater Elmira & Greater Corning Cities PUMA,191,142,49,88545.5497382199,113078.87323943662,17448.979591836734,101,76,25,116584.15841584158,150000.0,15000.0,90,66,24,57080.0,70563.63636363637,20000.0,0,0,0,#DIV/0!,0.0,0.0
103,"NYC-Brooklyn Community District 17--East Flatbush, Farragut & Rugby PUMA",1105,480,625,43834.57013574661,48310.416666666664,40397.12,347,144,203,59348.70317002882,63055.555555555555,56719.2118226601,588,229,359,36270.4081632653,42186.89956331878,32496.378830083566,170,107,63,38330.58823529412,41571.96261682243,32825.39682539683
104,Rockland County (North)--New City & Congers PUMA,2249,1398,851,40544.30858159182,41973.66952789699,38196.19271445359,309,191,118,79619.70873786407,99777.43455497382,46991.52542372881,1255,739,516,38669.768924302785,36048.17320703653,42424.34108527132,685,468,217,26351.970802919706,27739.529914529914,23359.447004608293
105,Saratoga County (Outer) PUMA,80,77,3,95036.875,98287.66233766233,11600.0,68,68,0,107737.5,107737.5,0.0,8,5,3,23100.0,30000.0,11600.0,4,4,0,23000.0,23000.0,0.0
106,Nassau County (Central)--Hempstead Town (North Central)--Meadowbrook Corridor PUMA,5750,3826,1924,35697.90782608696,39183.22530057501,28767.12577962578,518,297,221,53213.12741312741,53616.16161616162,52671.49321266968,3282,1948,1334,33850.05179768434,39942.618069815195,24953.260869565216,1950,1581,369,34155.230769230766,35536.242884250474,28238.211382113823
107,Putnam County PUMA,1576,1158,418,57174.149746192896,59963.09153713299,49447.846889952154,380,162,218,110730.52631578948,179392.59259259258,59706.422018348625,876,735,141,42761.41552511416,45002.448979591834,31079.432624113477,320,261,59,33030.8125,27964.98084291188,55440.67796610169
108,NYC-Brooklyn Community District 11--Bensonhurst & Bath Beach PUMA,2768,2266,502,37432.31575144509,37796.601941747576,35787.948207171314,407,275,132,35911.54791154791,32385.454545454544,43257.57575757576,1425,1107,318,38672.87719298246,39702.348690153565,35089.15094339623,936,884,52,36204.91452991453,37093.43891402715,21100.0
109,Orange County (Southeast) PUMA,1376,817,559,81177.39825581395,77923.5006119951,85933.09481216458,442,170,272,130203.61990950226,143135.29411764705,122121.32352941176,809,553,256,58593.695920889986,59872.87522603978,55830.46875,125,94,31,53982.4,66178.72340425532,17000.0
110,Onondaga County (Central)--Syracuse City (Outer) PUMA,311,190,121,80289.38906752411,55674.73684210526,118940.4958677686,186,110,76,112278.49462365592,66818.18181818182,178076.31578947368,94,49,45,27659.574468085106,35551.02040816326,19066.666666666668,31,31,0,47941.93548387097,47941.93548387097,0.0
111,"Rockland County (West)--Spring Valley, Suffern Villages & Monsey PUMA",2326,1699,627,32407.789337919174,30729.321954090643,36955.98086124402,269,226,43,56465.531598513015,58964.72566371682,43330.232558139534,1176,697,479,35415.63775510204,31898.263988522238,40533.82045929019,881,776,105,21047.10556186152,21456.18556701031,18023.809523809523
112,Monroe County (East) PUMA,271,171,100,62969.741697416976,69188.30409356725,52336.0,155,93,62,71946.45161290323,79856.98924731182,60080.645161290326,116,78,38,50975.0,56467.94871794872,39700.0,0,0,0,#DIV/0!,0.0,0.0
113,NYC-Manhattan Community District 10--Central Harlem PUMA,2185,954,1231,38133.18535469108,41576.05870020964,35465.02843216897,851,323,528,51706.11045828437,55026.93498452012,49674.621212121216,1132,478,654,29462.55300353357,35045.10460251046,25382.339449541283,202,153,49,29542.079207920793,33583.660130718956,16922.448979591838
114,Nassau County (Southwest)--Hempstead Town (Southwest) & Long Beach City PUMA,2192,1490,702,51110.994525547445,51618.523489932886,50033.76068376069,570,300,270,83433.15789473684,83395.0,83475.55555555556,1280,968,312,43830.0,48843.07851239669,28276.602564102563,342,222,120,24491.22807017544,20779.27927927928,31358.333333333332
115,Nassau County (Southeast)--Oyster Bay Town (South) PUMA,1663,954,709,50677.39025856885,57063.20754716981,42084.90832157969,379,157,222,87458.31134564643,120733.75796178344,63925.67567567567,1130,643,487,39487.16814159292,45060.34214618974,32128.747433264885,154,154,0,42268.181818181816,42268.181818181816,0.0
116,Wayne & Seneca Counties PUMA,257,150,107,78692.60700389105,95626.66666666667,54953.27102803739,160,103,57,114562.5,128679.61165048544,89052.63157894737,95,45,50,18884.21052631579,22000.0,16080.0,2,2,0,50000.0,50000.0,0.0
117,Schenectady County--Schenectady City PUMA,255,139,116,88477.25490196078,112846.76258992805,59275.862068965514,116,31,85,39152.58620689655,-5300.0,55364.705882352944,119,88,31,143193.27731092437,168977.27272727274,70000.0,20,20,0,49000.0,49000.0,0.0
118,"NYC-Brooklyn Community District 9--Crown Heights South, Prospect Lefferts & Wingate PUMA",1086,682,404,41094.19889502762,41427.85923753666,40530.94059405941,238,72,166,49457.98319327731,75027.77777777778,38367.469879518074,678,440,238,42394.24778761062,42585.90909090909,42039.91596638656,170,170,0,24200.0,24200.0,0.0
119,"NYC-Manhattan Community District 4 & 5--Chelsea, Clinton & Midtown Business District PUMA",3074,2228,846,79343.51659076122,84388.9631956912,66055.98108747046,1883,1590,293,105238.98566117897,102282.7106918239,121281.56996587031,821,457,364,42741.485992691836,45825.164113785555,38869.945054945056,370,181,189,28773.513513513513,24569.06077348066,32800.0
120,Westchester County (Northeast) PUMA,3300,2191,1109,42809.84848484849,40024.646280237335,48312.44364292155,843,319,524,73894.18742586003,88923.51097178683,64744.65648854962,1124,722,402,42221.88612099644,44910.110803324096,37393.78109452737,1333,1150,183,23647.636909227305,23393.304347826088,25245.90163934426
121,Nassau County (South Central)--Hempstead Town (Southeast) PUMA,2170,1320,850,54922.22119815668,59708.27272727273,47489.76470588235,703,393,310,88094.19630156472,108685.03816793892,61990.32258064516,1147,705,442,41010.02615518744,39761.27659574468,43001.80995475113,320,222,98,31914.0625,36351.35135135135,21862.244897959183
122,NYC-Queens Community District 2--Sunnyside & Woodside PUMA,6599,4192,2407,37881.59569631762,36716.5625,39910.60240963855,1431,685,746,54346.261355695315,58150.07299270073,50853.48525469169,4114,2628,1486,33133.27418570734,31220.079908675798,36516.76985195155,1054,879,175,34061.53700189753,36446.71217292378,22081.14285714286
123,"NYC-Staten Island Community District 3--Tottenville, Great Kills & Annadale PUMA",877,725,152,54117.058152793616,53559.393103448274,56776.97368421053,259,223,36,76124.32432432432,74489.68609865471,86250.0,528,430,98,47190.643939393936,45142.6976744186,56176.5306122449,90,72,18,31420.0,39000.0,1100.0
124,Suffolk County (Central)--Brookhaven Town (West Central) PUMA,1750,1160,590,47720.514285714286,50677.24137931035,41907.28813559322,168,67,101,79785.71428571429,95895.5223880597,69099.0099009901,1137,767,370,46879.15567282322,51752.28161668839,36777.2972972973,445,326,119,37764.7191011236,38854.601226993866,34778.991596638654
125,NYC-Queens Community District 9--Richmond Hill & Woodhaven PUMA,9193,5563,3630,46467.8489067769,50375.29660255258,40479.65840220386,2323,1255,1068,57923.49332759363,65606.94422310757,48894.7191011236,5701,3411,2290,44772.17330292931,48827.810026385225,38731.22270742358,1169,897,272,31973.05389221557,34949.163879598666,22158.45588235294
126,Suffolk County (Northwest)--Huntington Town (South) PUMA,603,321,282,112298.14262023217,129178.44236760125,93083.33333333333,153,34,119,78697.25490196078,75020.0,79747.89915966387,279,148,131,126304.30107526881,210131.0810810811,31599.236641221374,171,139,32,119509.94152046784,56231.65467625899,394375.0
127,"NYC-Bronx Community District 3 & 6--Belmont, Crotona Park East & East Tremont PUMA",7418,4337,3081,33840.16985710434,35136.05257090154,32016.007789678675,1849,1005,844,40926.868577609515,43478.388059701494,37888.62559241706,4248,2489,1759,32948.752354048964,34790.55042185617,30342.592382035247,1321,843,478,26787.50946252839,26210.67615658363,27804.81171548117
128,Suffolk County (North Central)--Brookhaven Town (North) PUMA,402,293,109,75881.34328358209,71895.22184300341,86596.33027522935,187,88,99,107417.11229946524,122136.36363636363,94333.33333333333,81,71,10,76172.83950617284,85492.95774647887,10000.0,134,134,0,31696.268656716416,31696.268656716416,0.0
129,NYC-Queens Community District 1--Astoria & Long Island City PUMA,6695,4500,2195,41009.71471247199,43259.46666666667,36397.46697038724,2046,1192,854,54048.543499511245,60002.36577181208,45738.29039812646,3246,2145,1101,33674.25138632163,34392.67132867133,32274.604904632153,1403,1163,240,38966.57163221668,42452.708512467754,22073.333333333332
130,Nassau County (West Central)--Hempstead Town (Northwest) PUMA,2459,1338,1121,55867.66978446523,56744.9177877429,54820.60660124889,426,188,238,90573.23943661971,110430.85106382979,74887.3949579832,1811,1015,796,49180.6736609608,48683.251231527094,49814.94974874372,222,135,87,43820.72072072072,42594.07407407407,45724.137931034486
131,Westchester County (Southeast) PUMA,5776,3843,1933,45615.84141274238,47370.77803799115,42126.8494568029,1166,618,548,84584.56260720412,106135.27508090615,60281.02189781022,2857,1706,1151,37516.10080504025,39153.98593200469,35088.444830582106,1753,1519,234,32896.7484312607,32690.98090849243,34232.47863247863
132,"NYC-Bronx Community District 10--Co-op City, Pelham Bay & Schuylerville PUMA",2718,1537,1181,59178.25239146431,67159.91541964866,48790.60118543607,720,173,547,60149.291666666664,64501.098265895955,58772.94332723949,1747,1177,570,63364.9685174585,73137.89294817332,43184.73684210526,251,187,64,27252.589641434264,31993.582887700533,13400.0
133,Suffolk County (South Central)--Brookhaven Town (South) PUMA,2262,1601,661,46237.66578249337,50312.05496564647,36369.13767019667,339,102,237,53519.174041297934,65245.098039215685,48472.573839662444,1515,1170,345,45180.46204620462,48584.957264957266,33634.782608695656,408,329,79,44113.23529411765,51824.31610942249,12000.0
134,Onondaga County (Central)--Syracuse City PUMA,800,498,302,33951.25,34167.26907630522,33595.03311258278,345,234,111,38613.333333333336,36694.8717948718,42657.657657657655,391,239,152,31614.833759590794,32923.430962343096,29557.236842105263,64,25,39,23093.75,22400.0,23538.46153846154
135,Suffolk County (West Central)--Babylon Town (Northwest) PUMA,3252,2170,1082,46509.348093480934,50597.64976958525,38310.07393715342,263,111,152,73756.65399239544,73565.76576576577,73896.05263157895,2182,1428,754,44712.328139321726,50563.72549019608,33630.37135278514,807,631,176,42488.35192069393,46634.07290015848,27625.0
136,Suffolk County (Southwest)--Islip Town (South) PUMA,1781,1246,535,46225.32285233015,49418.459069020864,38788.59813084112,383,268,115,62966.57963446475,62213.432835820895,64721.739130434784,910,696,214,49714.945054945056,52676.293103448275,40083.64485981308,488,282,206,26578.89344262295,29218.08510638298,22966.019417475727
137,Niagara County (North & East) PUMA,80,32,48,52325.0,37812.5,62000.0,63,15,48,48904.76190476191,7000.0,62000.0,17,17,0,65000.0,65000.0,0.0,0,0,0,#DIV/0!,0.0,0.0
138,NYC-Manhattan Community District 11--East Harlem PUMA,3860,2186,1674,40443.40932642487,31063.12900274474,52692.68817204301,938,220,718,65014.92537313433,58463.63636363636,67022.28412256268,1927,1264,663,37251.562013492476,28816.613924050635,53332.66968325792,995,702,293,23461.105527638192,26521.08262108262,16129.692832764506
139,Broome (Outer West) & Tioga Counties PUMA,145,61,84,77620.68965517242,136311.47540983607,35000.0,116,32,84,83275.86206896552,210000.0,35000.0,29,29,0,55000.0,55000.0,0.0,0,0,0,#DIV/0!,0.0,0.0
140,Albany County (East Central)--Albany City PUMA,385,209,176,44881.818181818184,44901.43540669856,44858.52272727273,133,45,88,54053.38345864662,59266.666666666664,51387.5,198,110,88,44143.43434343435,48794.545454545456,38329.545454545456,54,54,0,25000.0,25000.0,0.0
141,Nassau County (West Central)--Hempstead Town (West Central) PUMA,3643,2147,1496,54127.244029645895,54573.38146250582,53486.96524064171,739,374,365,87931.9350473613,94657.7540106952,81040.27397260274,2551,1489,1062,46969.36495491964,47795.19811954332,45811.48775894538,353,284,69,35084.98583569405,37323.94366197183,25869.565217391304
142,Nassau County (West Central)--North Hempstead Town (South) PUMA,3172,2045,1127,46802.143757881466,44926.45476772616,50205.67879325643,724,343,381,76624.30939226519,86431.48688046647,67795.27559055119,1794,1209,585,39303.121516164996,37036.145574855254,43988.205128205125,654,493,161,34358.71559633027,35399.39148073022,31172.049689440995
143,Nassau County (Central)--Hempstead Town (Northeast) PUMA,2404,1669,735,54844.59567387687,57737.332534451765,48275.91836734694,305,107,198,66216.7475409836,78916.89719626168,59353.53535353536,1529,1014,515,56755.06867233486,62871.49901380671,44712.23300970874,570,548,22,43634.73684210526,44101.824817518245,32000.0
144,Nassau County (Central)--Hempstead Town (East Central) PUMA,863,375,488,67407.99536500579,81050.13333333333,56924.79508196721,384,242,142,97875.0,102126.03305785124,90630.28169014085,310,85,225,52947.096774193546,45851.76470588235,55627.555555555555,169,48,121,24707.100591715975,37122.916666666664,19781.81818181818
145,"NYC-Bronx Community District 5--Morris Heights, Fordham South & Mount Hope PUMA",7314,3989,3325,31413.70248837845,33207.34519929807,29261.870676691728,1826,872,954,36300.98576122672,38843.119266055044,33977.35849056604,4215,2357,1858,31396.161328588376,33627.83198981756,28565.1345532831,1273,760,513,24461.429693637077,25436.973684210527,23016.17933723197
146,Capital Region,1721,1178,543,494630.32660890295,521849.66376480146,377309.91393513425,610,352,258,577978.6818563266,505955.86881897086,407184.20588235295,871,624,247,413662.4059636739,478737.9455485589,252076.72656800563,240,202,38,226003.7634408602,224273.07692307694,52000.0
147,Central NY,1726,1073,653,300489.474483819,237599.4248459264,357099.4110442335,770,421,349,400961.8700726835,272055.9107559108,479457.11394299904,819,554,265,231876.00483197113,218189.56278453473,164623.9035087719,137,98,39,99035.68548387097,98341.93548387097,23538.46153846154
148,Finger Lakes,2816,1694,1122,460619.4938566892,517546.1605733373,382205.8805358114,821,454,367,582761.1481910634,682957.7129388641,315845.41325211845,1338,742,596,345289.2472126117,385805.55325545184,312734.42781534535,657,498,159,272905.92479026446,268879.93547302124,97061.6
149,Long Island,64079,41489,22590,1310844.5564889722,1398610.2249832184,1182893.178524956,10811,5832,4979,1889023.7908022213,2079766.6566810177,1699769.282897835,37440,23625,13815,1199895.4804460856,1370540.9250386506,888380.0971022483,15828,12032,3796,973758.7468481122,955571.5384199204,969252.5681397723
150,Mid-Hudson,51336,33843,17493,777093.7370587332,758346.5227540227,805000.7625623452,11605,5172,6433,1329161.7445532165,1572556.3229756863,1153803.4519910344,26484,17597,8887,659180.2305293429,681060.8387089649,601972.8921663564,13247,11074,2173,542337.8347213494,570363.7513577604,410994.88237270154
151,Mohawk Valley,745,472,273,123275.1821159503,130200.30144764377,105306.6615811373,166,49,117,231250.89324618736,215683.63636363635,73415.66176470587,330,188,142,101788.85579708475,103839.13043478261,95379.84962406015,249,235,14,74958.30673510142,75797.46757426225,13000.0
152,New York City,246639,150292,96347,2676766.752676095,2800852.9182977304,2515823.9642320443,61360,30484,30876,3665910.6619803305,4030308.4764532316,3353589.35306312,137103,83672,53431,2182849.1746204644,2270940.6283051404,2013338.8682095967,48176,36136,12040,1626034.970950695,1660629.0564418668,1335133.9728108188
153,North Country,834,587,247,158435.26557558234,164967.09574934267,144601.08550039402,254,180,74,292658.7801066373,364454.8494983278,182268.1093117409,418,245,173,93271.90728712676,66151.56695156696,123624.8254564984,162,162,0,89778.23691460055,89778.23691460055,0.0
154,Southern Tier,803,539,264,321870.9641588572,417369.0034375738,147415.80310648633,373,243,130,434598.12654541316,595161.0810810811,96019.04761904762,410,276,134,257247.1412984179,281531.7414293024,112960.4743083004,20,20,0,51111.11111111111,51111.11111111111,0.0
155,Western NY,1721,855,866,546704.3642961571,571987.8852051108,353063.89940090437,884,395,489,597899.321767606,493775.6758521614,351127.92544330505,652,326,326,392320.24790436815,408674.08496732026,204480.39215686274,185,134,51,134468.38811672485,115264.05375139977,33842.10526315789
