,puma,Total_geo,Total_geo_m,Total_geo_f,Total_Avg_PINCP_mf_t,Total_Avg_PINCP_m,Total_Avg_PINCP_f,Total_BABS,Total_BABS_m,Total_BABS_f,BABS_Avg_PINCP_mf_t,BABS_Avg_PINCP_m,BABS_Avg_PINCP_f,Total_HS,Total_HS_m,Total_HS_f,HS_Avg_PINCP_mf_t,HS_Avg_PINCP_m,HS_Avg_PINCP_f,Total_HSINC,Total_HSINC_m,Total_HSINC_f,HSINC_Avg_PINCP_mf_t,HSINC_Avg_PINCP_m,HSINC_Avg_PINCP_f
0,Total Geo,270664,158019,112645,81485.96168681465,92799.57315892393,65615.16785476496,150730,80721,70009,104578.40856498375,126370.96361541607,79451.39866302905,102999,64719,38280,52838.631598365035,58489.662572042216,43284.58056426332,16935,12579,4356,50185.21375848834,53892.417918753476,39479.7681359045
1,Westchester County (Southwest)--Yonkers City PUMA,3552,2256,1296,72217.5365990991,75448.34219858157,66593.54166666667,1667,935,732,85633.84523095381,93944.21390374332,75018.82513661202,1479,1010,469,55763.13049357674,62102.59405940594,42110.98081023454,406,311,95,77072.41379310345,63183.27974276528,122541.05263157895
2,St. Lawrence County PUMA,617,349,268,69374.39222042139,68244.12607449856,70846.26865671642,295,95,200,104381.35593220338,142331.57894736843,86355.0,232,195,37,46112.5,49751.282051282054,26935.135135135137,90,59,31,14593.333333333334,10071.186440677966,23200.0
3,"NYC-Queens Community District 7--Flushing, Murray Hill & Whitestone PUMA",3095,1821,1274,60989.586429725365,63938.98407468424,56773.846153846156,918,403,515,75071.78649237473,90911.66253101737,62676.69902912621,1644,1010,634,55639.142335766424,55421.039603960395,55986.59305993691,533,408,125,53238.499061913695,58382.94117647059,36447.04
4,Erie County (Central) PUMA,945,532,413,39781.12169312169,40450.338345864664,38919.0799031477,250,82,168,50721.52,51664.634146341465,50261.19047619047,619,387,232,36357.576736672054,39110.18087855297,31765.94827586207,76,63,13,31676.842105263157,34086.34920634921,20000.0
5,Monroe County (South) PUMA,1546,929,617,84287.60672703752,93261.6146393972,70775.68881685575,1098,617,481,97325.81056466303,108923.88978930308,82448.44074844074,410,289,121,52114.39024390244,61674.740484429065,29280.165289256198,38,23,15,54684.21052631579,70000.0,31200.0
6,Onondaga County (North) PUMA,990,546,444,53704.080808080806,57306.48351648352,49274.0990990991,467,275,192,71064.75374732334,71197.23636363636,70875.0,465,213,252,37307.096774193546,42620.18779342723,32816.269841269845,58,58,0,45379.31034482759,45379.31034482759,0.0
7,"NYC-Bronx Community District 9--Castle Hill, Clason Point & Parkchester PUMA",229,141,88,19467.248908296944,17432.624113475176,22727.272727272728,0,0,0,#DIV/0!,0.0,0.0,137,69,68,22941.605839416057,22652.17391304348,23235.29411764706,92,72,20,14293.478260869566,12430.555555555555,21000.0
8,"Clinton, Franklin, Essex & Hamilton Counties PUMA",462,208,254,47796.77489177489,57329.855769230766,39990.15748031496,160,50,110,68368.125,84636.0,60973.63636363636,238,109,129,34820.84033613445,48394.12844036697,23351.937984496122,64,49,15,44622.65625,49343.87755102041,29200.0
9,Suffolk County (Southwest)--Babylon Town (Southeast) PUMA,1531,1039,492,66053.5009797518,69546.20789220404,58677.64227642276,543,287,256,93420.99447513813,104625.08710801393,80860.15625,856,653,203,50582.02102803739,54978.57580398162,36439.40886699507,132,99,33,53803.78787878788,63940.40404040404,23393.939393939392
10,Suffolk County (Northwest)--Smithtown Town PUMA,932,667,265,88376.48068669529,92136.55172413793,78912.45283018867,572,381,191,101691.3986013986,107315.69553805774,90472.25130890052,331,257,74,70813.89728096676,77073.15175097276,49075.67567567567,29,29,0,26206.896551724138,26206.896551724138,0.0
11,"NYC-Bronx Community District 12--Wakefield, Williamsbridge & Woodlawn PUMA",556,374,182,55603.41726618705,64082.085561497326,38180.21978021978,148,110,38,89108.1081081081,107800.0,35000.0,369,249,120,45167.20867208672,46219.67871485944,42983.333333333336,39,15,24,27200.0,40000.0,19200.0
12,Dutchess County (Southwest) PUMA,1001,510,491,59262.22777222777,61944.490196078434,56476.17107942973,498,192,306,79938.13253012048,95884.32291666667,69932.67973856209,447,262,185,38589.26174496644,41675.57251908397,34218.37837837838,56,56,0,40408.92857142857,40408.92857142857,0.0
13,Ulster County (East) PUMA,424,358,66,67989.17452830188,67769.0502793296,69183.18181818182,156,112,44,124221.73076923077,140111.60714285713,83774.77272727272,218,196,22,35111.55963302752,34562.857142857145,40000.0,50,50,0,35890.0,35890.0,0.0
14,Orange County (Northwest) PUMA,589,350,239,69063.39558573854,72658.97142857143,63797.907949790795,218,75,143,73332.29357798165,65276.53333333333,77557.34265734266,287,191,96,63217.770034843204,73227.74869109948,43302.083333333336,84,84,0,77957.14285714286,77957.14285714286,0.0
15,"NYC-Bronx Community District 11--Pelham Parkway, Morris Park & Laconia PUMA",2508,1641,867,46835.32296650718,48221.870810481414,44210.957324106115,864,537,327,59290.2662037037,57228.845437616386,62675.53516819572,1424,939,485,40040.02808988764,43616.61341853035,33115.463917525776,220,165,55,41905.454545454544,45116.36363636364,32272.727272727272
16,"NYC-Manhattan Community District 1 & 2--Battery Park City, Greenwich Village & Soho PUMA",5331,3123,2208,169709.90189457888,202418.8078770413,123446.35416666667,4654,2689,1965,182594.2279759347,219015.986240238,132752.951653944,365,233,132,55783.42465753425,49514.80686695279,66848.48484848485,312,201,111,110798.07692307692,157626.8656716418,26000.0
17,"NYC-Brooklyn Community District 12--Borough Park, Kensington & Ocean Parkway PUMA",4426,2943,1483,49787.153185720745,54605.84437648658,40224.50438300742,1796,954,842,65072.23830734967,80256.70859538784,47867.980997624705,2158,1584,574,38678.776645041704,41378.156565656565,31229.616724738677,472,405,67,42413.983050847455,45918.765432098764,21228.358208955226
18,"NYC-Staten Island Community District 1--Port Richmond, Stapleton & Mariner's Harbor PUMA",2963,1902,1061,58780.2328720891,63352.20820189275,50584.288407163054,1472,863,609,71567.81929347826,83976.5932792584,53983.6288998358,1362,925,437,47373.715124816445,47728.75675675676,46622.19679633867,129,114,15,33294.573643410855,33991.228070175435,28000.0
19,Monroe County (Central)--Greece & Gates Towns PUMA,1014,631,383,53883.78698224852,63111.50554675119,38680.93994778068,272,161,111,81818.38235294117,101968.94409937889,52590.99099099099,700,443,257,43707.171428571426,49543.61173814898,33646.69260700389,42,27,15,42584.28571428572,54020.0,22000.0
20,Westchester County (South Central)--New Rochelle & Mount Vernon Cities PUMA,3038,2076,962,109390.73732718894,117489.91329479769,91912.68191268192,1350,773,577,175542.7037037037,210994.11384217336,128048.87348353553,1377,1116,261,59501.459694989106,63862.82258064516,40852.87356321839,311,187,124,43128.295819935694,51014.438502673795,31235.483870967742
21,Orange County (Northeast)--Greater Newburgh City PUMA,657,420,237,59622.80060882801,70351.85714285714,40609.28270042194,278,167,111,80885.53956834532,90755.56886227545,66036.03603603604,312,186,126,34728.846153846156,45919.354838709674,18209.52380952381,67,67,0,87322.3880597015,87322.3880597015,0.0
22,Suffolk County (East) PUMA,2174,1164,1010,84087.04691812328,113872.50859106529,49760.039603960395,755,381,374,120497.40397350994,174790.28871391076,65188.342245989305,1330,719,611,64561.12781954887,84524.47844228095,41069.06710310966,89,64,25,67004.49438202247,80928.125,31360.0
23,Tompkins County PUMA,724,397,327,77516.85082872928,103035.26448362721,46535.779816513765,579,314,265,88288.94645941278,117719.74522292994,53416.22641509434,145,83,62,34502.75862068965,47481.927710843374,17127.41935483871,0,0,0,#DIV/0!,0.0,0.0
24,Monroe County (Central)--Rochester City (East) PUMA,270,219,51,67298.44444444444,74735.61643835617,35362.35294117647,104,80,24,98671.15384615384,115822.5,41500.0,144,117,27,51205.416666666664,56120.51282051282,29906.666666666668,22,22,0,24327.272727272728,24327.272727272728,0.0
25,Ontario & Yates Counties PUMA,573,337,236,116134.93891797557,173818.99109792284,33764.06779661017,407,322,85,153777.19901719902,179624.22360248448,55862.58823529412,149,15,134,23140.939597315435,49200.0,20223.880597014926,17,0,17,30000.0,0.0,30000.0
26,"NYC-Bronx Community District 7--Bedford Park, Fordham North & Norwood PUMA",689,539,150,30954.86211901306,27714.285714285714,42599.333333333336,175,156,19,28548.571428571428,22891.02564102564,75000.0,306,253,53,35849.67320261438,30790.513833992096,60000.0,208,130,78,25778.365384615383,27515.384615384617,22883.333333333332
27,Chautauqua County PUMA,253,170,83,55168.75889328063,64144.09411764706,36785.5421686747,111,60,51,74334.1981981982,103318.26666666666,40235.294117647056,127,95,32,39028.34645669291,41635.78947368421,31287.5,15,15,0,50000.0,50000.0,0.0
28,Genesee & Orleans Counties PUMA,77,51,26,50610.38961038961,62078.43137254902,28115.384615384617,6,0,6,42500.0,0.0,42500.0,71,51,20,51295.77464788732,62078.43137254902,23800.0,0,0,0,#DIV/0!,0.0,0.0
29,"NYC-Brooklyn Community District 15--Sheepshead Bay, Gerritsen Beach & Homecrest PUMA",16077,8508,7569,64975.13366921689,72591.63457921956,56413.73985995508,10307,5002,5305,74913.89288832832,85861.11095561775,64591.93534401508,5147,2994,2153,48136.667961919564,56826.00200400801,36053.12587087785,623,512,111,39660.19261637239,35147.0703125,60477.47747747748
30,Broome County (West Central)--Greater Binghamton City & Greater Johnson City Village PUMA,800,536,264,69523.825,81630.70895522388,44943.181818181816,409,263,146,92815.7946210269,112108.97338403043,58061.643835616436,294,176,118,38064.62585034013,44335.22727272727,28711.86440677966,97,97,0,66663.9175257732,66663.9175257732,0.0
31,Westchester County (Central)--White Plains City PUMA,3009,1696,1313,154190.90063143903,207029.48113207548,85939.3907083016,2335,1277,1058,183543.25481798715,255761.00234925607,96376.84310018904,600,345,255,53257.36666666667,61109.27536231884,42634.19607843137,74,74,0,46385.13513513513,46385.13513513513,0.0
32,Nassau County (Northwest)--North Hempstead Town (North) PUMA,3382,2274,1108,130250.20047309285,162385.83113456465,64296.74909747292,2014,1314,700,153097.0099304866,192279.13242009134,79546.56857142856,1176,777,399,103773.29931972788,137086.74388674388,38899.74937343358,192,183,9,52767.708333333336,55159.56284153005,4133.333333333333
33,Cattaraugus & Allegany Counties PUMA,178,90,88,49479.213483146064,56711.11111111111,42082.954545454544,85,20,65,54372.94117647059,75150.0,47980.0,79,56,23,48222.784810126584,57589.28571428572,25417.391304347828,14,14,0,26857.14285714286,26857.14285714286,0.0
34,NYC-Brooklyn Community District 1--Greenpoint & Williamsburg PUMA,4288,2562,1726,78432.27402052238,86783.31420765027,66036.34994206257,2141,1205,936,96771.99486221392,115659.62738589212,72456.18589743589,1850,1131,719,64341.86486486487,67177.45358090186,59881.43254520167,297,226,71,33994.276094276094,30934.95575221239,43732.394366197186
35,Suffolk County (Northwest)--Huntington Town (North) PUMA,600,338,262,111822.83333333333,107790.23668639053,117025.19083969465,359,203,156,144750.6963788301,141268.47290640394,149282.05128205128,153,63,90,59232.67973856209,48819.04761904762,66522.22222222222,88,72,16,68927.27272727272,65000.0,86600.0
36,"NYC-Manhattan Community District 9--Hamilton Heights, Manhattanville & West Harlem PUMA",1725,959,766,80025.62318840579,79657.00729927007,80487.11488250653,1262,615,647,93128.8589540412,98728.86178861788,87805.82689335394,408,289,119,36802.89215686275,35200.06920415225,40695.46218487395,55,55,0,100000.0,100000.0,0.0
37,NYC-Brooklyn Community District 10--Bay Ridge & Dyker Heights PUMA,6544,3950,2594,68692.4060207824,74779.2493670886,59423.69699306091,3704,1995,1709,89905.83288336934,105098.46365914786,72170.72557050906,2580,1754,826,41882.1472868217,45147.229190421895,34948.78934624697,260,201,59,32522.923076923078,32429.65174129353,32840.67796610169
38,"NYC-Brooklyn Community District 6--Park Slope, Carroll Gardens & Red Hook PUMA",2752,1720,1032,99849.53851744186,119287.95348837209,67452.18023255814,2354,1389,965,109726.79694137638,138627.4874010079,68127.77202072539,388,321,67,42332.6030927835,39120.56074766355,57721.64179104478,10,10,0,6400.0,6400.0,0.0
39,Livingston & Wyoming Counties PUMA,171,118,53,56379.649122807015,59766.4406779661,48839.24528301887,64,54,10,53428.75,52156.2962962963,60300.0,107,64,43,58144.67289719626,66187.5,46173.95348837209,0,0,0,#DIV/0!,0.0,0.0
40,Albany County (Outside Albany City) PUMA,1515,893,622,75203.02310231022,84095.68868980963,62435.900321543406,743,406,337,102360.92866756393,122385.56650246306,78236.29080118694,704,463,241,50906.974431818184,53064.600431965446,46761.825726141076,68,24,44,29998.529411764706,35000.0,27270.454545454544
41,NYC-Manhattan Community District 3--Chinatown & Lower East Side PUMA,2857,1425,1432,109385.50717535877,139990.0098245614,78930.60754189944,2227,1158,1069,122253.89492590929,151478.55267702937,90596.12722170253,605,267,338,65793.33884297521,90163.29588014982,46542.514792899405,25,0,25,18000.0,0.0,18000.0
42,Nassau County (Northeast)--Oyster Bay Town (North) & Glen Cove City PUMA,1743,1090,653,139850.84911072862,182164.22018348624,69220.56661562022,930,508,422,183539.60215053763,263854.7244094488,86856.94312796209,588,422,166,69829.42176870749,79452.1327014218,45366.867469879515,225,160,65,142260.0,193700.0,15638.461538461539
43,"NYC-Queens Community District 11--Bayside, Douglaston & Little Neck PUMA",2851,1814,1037,77974.43002455278,84707.210584344,66196.93346190936,1143,628,515,89980.61242344706,92768.1847133758,86581.39805825242,1469,1007,462,73624.23417290674,85874.08142999007,46923.80952380953,239,179,60,47293.97489539749,49861.78770949721,39633.333333333336
44,Erie County (South) PUMA,374,220,154,53682.29946524064,66057.54545454546,36003.37662337662,244,165,79,61091.80327868852,69426.66666666667,43683.54430379747,130,55,75,39775.230769230766,55950.181818181816,27913.6,0,0,0,#DIV/0!,0.0,0.0
45,NYC-Manhattan Community District 7--Upper West Side & West Side PUMA,6657,3235,3422,159357.007360673,224176.13539412673,98080.01168907071,5150,2529,2621,189785.91650485437,267686.34638196917,114619.87790919497,1036,536,500,62002.440154440155,75151.17164179105,47907.0,471,170,301,40780.46709129512,46764.705882352944,37400.664451827244
46,"NYC-Queens Community District 12--Jamaica, Hollis & St. Albans PUMA",321,174,147,34296.88473520249,37941.9540229885,29982.312925170067,54,14,40,30962.962962962964,2000.0,41100.0,156,76,80,34342.94871794872,40078.94736842105,28893.75,111,84,27,35854.05405405405,41998.80952380953,16737.037037037036
47,NYC-Brooklyn Community District 3--Bedford-Stuyvesant PUMA,931,671,260,66486.46616541353,70535.76751117734,56036.153846153844,623,396,227,79517.01444622793,91469.9494949495,58665.19823788546,251,218,33,36168.924302788844,35899.08256880734,37951.51515151515,57,57,0,57568.42105263158,57568.42105263158,0.0
48,Dutchess County (North & East) PUMA,676,392,284,81971.15384615384,94817.85714285714,64239.08450704225,244,167,77,98751.22950819672,88114.37125748504,121820.77922077922,418,211,207,72074.64114832536,100774.88151658767,42819.80676328502,14,14,0,85000.0,85000.0,0.0
49,Oneida County (Central)--Greater Utica & Rome Cities PUMA,1526,753,773,39330.9003931848,44558.2390438247,34238.80983182406,471,208,263,47102.61995753716,50612.66346153846,44326.61596958175,876,444,432,34247.511415525114,38900.72072072072,29465.046296296296,179,101,78,43758.659217877095,56960.39603960396,26664.102564102563
50,NYC-Brooklyn Community District 7--Sunset Park & Windsor Terrace PUMA,1816,1049,767,61544.052863436125,65435.74833174452,56221.512385919166,1149,655,494,70263.70757180157,76107.63358778626,62515.182186234815,552,350,202,49130.434782608696,48878.857142857145,49566.33663366337,115,44,71,34008.69565217391,38272.72727272727,31366.197183098593
51,"NYC-Bronx Community District 1 & 2--Hunts Point, Longwood & Melrose PUMA",276,210,66,38605.07246376811,35585.71428571428,48212.121212121216,51,0,51,46215.686274509804,0.0,46215.686274509804,197,182,15,39274.1116751269,37978.02197802198,55000.0,28,28,0,20035.714285714286,20035.714285714286,0.0
52,Warren & Washington Counties PUMA,519,239,280,70480.57803468208,97577.07112970711,47351.78571428572,281,162,119,95415.65836298933,123308.64197530864,57443.6974789916,225,64,161,42256.08888888889,48201.875,39892.54658385093,13,13,0,20000.0,20000.0,0.0
53,Oswego County PUMA,244,54,190,64362.86885245902,95277.77777777778,55576.52631578947,140,20,120,83073.85714285714,194500.0,64502.833333333336,93,23,70,40023.655913978495,39260.86956521739,40274.28571428572,11,11,0,32000.0,32000.0,0.0
54,Erie County (Northeast) PUMA,418,353,65,104545.93301435407,112660.62322946175,60476.92307692308,147,122,25,145755.10204081633,161278.68852459016,70000.0,271,231,40,82192.61992619926,86983.54978354978,54525.0,0,0,0,#DIV/0!,0.0,0.0
55,Herkimer (North & Central) & Oneida (Outer) Counties PUMA,336,128,208,42620.86309523809,46187.5,40426.00961538462,136,53,83,63103.30882352941,71245.28301886792,57904.21686746988,191,66,125,28160.0,26909.090909090908,28820.48,9,9,0,40000.0,40000.0,0.0
56,Saratoga County (South & Central) PUMA,758,335,423,92717.28232189974,124674.92537313433,67408.0378250591,595,257,338,108036.3025210084,148936.96498054476,76937.27810650888,163,78,85,36798.15950920245,44734.61538461538,29515.29411764706,0,0,0,#DIV/0!,0.0,0.0
57,Columbia & Greene Counties PUMA,334,215,119,84744.91017964072,109747.90697674418,39571.42857142857,210,168,42,117218.09523809524,128516.66666666667,72023.80952380953,118,47,71,30403.389830508473,42659.574468085106,22290.140845070422,6,0,6,16900.0,0.0,16900.0
58,"NYC-Queens Community District 8--Briarwood, Fresh Meadows & Hillcrest PUMA",5339,3123,2216,62384.53774115003,68745.79154658981,53419.648014440434,2589,1375,1214,75204.90536886829,87238.22545454545,61575.73311367381,2572,1608,964,51448.73522550544,55699.71828358209,44357.883817427384,178,140,38,33929.213483146064,36967.142857142855,22736.842105263157
59,NYC-Queens Community District 6--Forest Hills & Rego Park PUMA,7360,3985,3375,75476.93614130435,87302.747804266,61513.718518518515,4133,1943,2190,87153.31478345027,107310.16469377252,69269.86301369863,2750,1685,1065,65336.0,74766.646884273,50415.211267605635,477,357,120,32770.6498951782,37579.83193277311,18463.333333333332
60,NYC-Queens Community District 10--Howard Beach & Ozone Park PUMA,1412,983,429,61681.798866855526,69073.4486266531,44744.755244755244,440,289,151,67757.72727272728,78378.54671280277,47430.46357615894,680,410,270,62574.117647058825,74880.24390243902,43887.03703703704,292,284,8,50448.28767123288,51221.47887323944,23000.0
61,Erie County (North Central) PUMA,1138,660,478,86763.11423550088,107091.69696969698,58694.359832635986,952,539,413,98014.2268907563,124016.77179962894,64078.702179176755,135,70,65,31573.333333333332,38157.142857142855,24483.076923076922,51,51,0,22832.941176470587,22832.941176470587,0.0
62,NYC-Brooklyn Community District 16--Brownsville & Ocean Hill PUMA,129,114,15,38926.35658914729,41745.61403508772,17500.0,15,0,15,17500.0,0.0,17500.0,59,59,0,46949.15254237288,46949.15254237288,0.0,55,55,0,36163.63636363636,36163.63636363636,0.0
63,NYC-Staten Island Community District 2--New Springville & South Beach PUMA,7421,4559,2862,69249.83236760544,73604.84448343934,62312.55066387142,3885,2192,1693,82408.4211068211,87089.049270073,76348.2102776137,2999,1908,1091,54713.93464488163,61536.734800838574,42781.85151237397,537,459,78,55231.28491620112,59375.163398692814,30846.153846153848
64,Madison & Cortland Counties PUMA,315,134,181,92116.03174603175,143645.5223880597,53967.127071823204,214,88,126,122120.32710280374,201426.13636363635,66732.14285714286,101,46,55,28542.574257425742,33108.69565217391,24723.636363636364,0,0,0,#DIV/0!,0.0,0.0
65,Westchester County (Northwest) PUMA,2142,1317,825,98891.87675070028,113622.77904328018,75376.0,1268,746,522,122980.04731861199,143015.54959785522,94346.93486590039,707,462,245,61998.727015558696,71174.45887445887,44695.91836734694,167,109,58,72183.23353293413,92376.14678899082,34234.48275862069
66,NYC-Brooklyn Community District 4--Bushwick PUMA,755,434,321,43882.03973509934,47767.60368663594,38628.66043613707,530,276,254,42681.32075471698,46322.82608695652,38724.4094488189,170,103,67,49469.64705882353,56757.669902912625,38265.67164179104,55,55,0,38181.818181818184,38181.818181818184,0.0
67,"Rockland County (South)--Orangetown, Clarkstown (South) & Ramapo (Southeast) Towns PUMA",1105,524,581,78743.04977375566,107742.97709923664,52588.2099827883,683,279,404,89505.30014641289,136162.43727598566,57284.158415841586,385,208,177,56607.66233766234,69149.03846153847,41869.774011299436,37,37,0,110405.4054054054,110405.4054054054,0.0
68,"NYC-Manhattan Community District 12--Washington Heights, Inwood & Marble Hill PUMA",2178,1489,689,57143.783287419654,54636.440564137,62562.40928882438,1337,795,542,64579.476439790575,65716.67924528301,62911.43911439114,745,598,147,48985.23489932886,45964.04682274247,61275.510204081635,96,96,0,16900.0,16900.0,0.0
69,NYC-Brooklyn Community District 2--Brooklyn Heights & Fort Greene PUMA,2126,1381,745,126253.00564440263,139103.17885590153,102432.75167785234,1849,1119,730,138547.2363439697,161055.799821269,104044.38356164383,208,193,15,54827.16346153846,57223.05699481865,24000.0,69,69,0,12115.942028985508,12115.942028985508,0.0
70,"NYC-Queens Community District 14--Far Rockaway, Breezy Point & Broad Channel PUMA",1329,711,618,64330.188111361924,74494.96483825598,52635.760517799354,741,328,413,82138.75843454791,112561.9512195122,57976.99757869249,536,331,205,38899.253731343284,37056.19335347432,41875.12195121951,52,52,0,72692.30769230769,72692.30769230769,0.0
71,Suffolk County (Central)--Islip Town (East) PUMA,836,595,241,69692.77511961723,78902.95798319328,46953.94190871369,377,279,98,99696.18037135279,112177.27598566309,64163.26530612245,420,277,143,44318.80952380953,49046.93140794224,35160.13986013986,39,39,0,52917.94871794872,52917.94871794872,0.0
72,NYC-Brooklyn Community District 14--Flatbush & Midwood PUMA,5115,2898,2217,52958.19315738026,60344.82332643202,43302.59810554804,2676,1316,1360,58169.97683109118,78050.54559270517,38932.60294117647,2113,1443,670,42962.84902981543,44135.81427581428,40436.59701492537,326,139,187,74962.57668711657,60984.17266187051,85352.94117647059
73,"NYC-Bronx Community District 4--Concourse, Highbridge & Mount Eden PUMA",116,90,26,35856.89655172414,32226.666666666668,48423.07692307692,26,0,26,48423.07692307692,0.0,48423.07692307692,90,90,0,32226.666666666668,32226.666666666668,0.0,0,0,0,#DIV/0!,0.0,0.0
74,Erie County (West Central)--Buffalo City (East) PUMA,366,302,64,43508.19672131148,33678.807947019865,89890.625,100,36,64,79370.0,60666.666666666664,89890.625,187,187,0,28352.941176470587,28352.941176470587,0.0,79,79,0,33987.3417721519,33987.3417721519,0.0
75,Nassau County (East Central)--Oyster Bay Town (Central) PUMA,1854,1090,764,80504.02858683927,94995.37155963303,59829.206806282724,802,465,337,104029.76309226932,122056.94623655915,79155.45994065281,812,509,303,62134.77709359606,69684.31237721021,49452.55445544554,240,116,124,64038.166666666664,97578.96551724138,32661.290322580644
76,Niagara County (Southwest)--Greater Niagara Falls & North Tonawanda Area PUMA,102,48,54,39209.80392156863,57916.666666666664,22581.48148148148,46,10,36,45217.391304347824,110000.0,27222.222222222223,38,20,18,12615.78947368421,12000.0,13300.0,18,18,0,80000.0,80000.0,0.0
77,"NYC-Manhattan Community District 6--Murray Hill, Gramercy & Stuyvesant Town PUMA",3348,1650,1698,118865.45937873358,118607.06545454546,119116.54888103652,2871,1392,1479,131286.89655172414,134018.52011494254,128715.9567275186,289,144,145,32293.695501730104,14568.597222222223,49896.55172413793,188,114,74,62255.31914893617,61842.10526315789,62891.89189189189
78,Jefferson & Lewis Counties PUMA,366,130,236,57476.502732240435,106811.53846153847,30300.42372881356,144,63,81,92393.75,172842.85714285713,29822.222222222223,182,27,155,34350.0,56162.96296296296,30550.322580645163,40,40,0,37000.0,37000.0,0.0
79,Fulton & Montgomery Counties PUMA,363,131,232,32191.515151515152,41726.10687022901,26807.758620689656,57,6,51,19682.80701754386,81020.0,12466.666666666666,279,98,181,34862.36559139785,42275.510204081635,30848.618784530387,27,27,0,31000.0,31000.0,0.0
80,"NYC-Bronx Community District 8--Riverdale, Fieldston & Kingsbridge PUMA",1941,1123,818,88279.87635239567,109603.50845948352,59005.50122249389,1461,757,704,102249.37713894593,140942.0607661823,60643.75,399,306,93,44624.81203007519,45120.91503267974,42992.47311827957,81,60,21,51353.08641975309,43076.666666666664,75000.0
81,NYC-Brooklyn Community District 8--Crown Heights North & Prospect Heights PUMA,1027,652,375,94303.44206426485,110046.92024539877,66930.78133333333,746,413,333,119507.55361930295,160932.42615012106,68130.75975975976,223,203,20,28632.286995515697,23908.86699507389,76575.0,58,36,22,22620.689655172413,12000.0,40000.0
82,NYC-Queens Community District 3--Jackson Heights & North Corona PUMA,1894,1316,578,72538.69060190074,80284.26291793313,54903.4429065744,1199,774,425,79594.81234361968,91879.83204134367,57221.623529411765,541,420,121,54025.87800369686,54221.42857142857,53347.10743801653,154,122,32,82637.01298701299,96443.44262295082,30000.0
83,Monroe County (North & West) PUMA,809,315,494,50673.189122373304,55045.23809523809,47885.34412955466,340,72,268,57137.94117647059,65569.44444444444,54872.76119402985,403,177,226,49646.92307692308,62475.98870056497,39599.38053097345,66,66,0,23636.363636363636,23636.363636363636,0.0
84,NYC-Brooklyn Community District 5--East New York & Starrett City PUMA,222,174,48,73920.72072072072,58502.29885057471,129812.5,74,50,24,157005.4054054054,134928.0,203000.0,128,104,24,33687.5,28394.23076923077,56625.0,20,20,0,24000.0,24000.0,0.0
85,"Steuben (North & West), Schuyler & Chemung (North) Counties PUMA",83,33,50,49228.9156626506,57151.51515151515,44000.0,58,26,32,48413.793103448275,56384.61538461538,41937.5,17,7,10,46941.17647058824,60000.0,37800.0,8,0,8,60000.0,0.0,60000.0
86,NYC-Brooklyn Community District 13--Brighton Beach & Coney Island PUMA,11713,5843,5870,63639.88158456416,66708.24285469794,60585.63373083475,7155,3589,3566,77926.82361984625,78620.35190860963,77228.82220975883,4280,2028,2252,41583.72897196261,49011.67159763313,34894.62255772646,278,226,52,35500.539568345324,36336.94690265487,31865.384615384617
87,NYC-Manhattan Community District 8--Upper East Side PUMA,8787,4815,3972,179916.2467281211,237071.51817237798,110630.58912386707,7804,4187,3617,185165.61250640696,247411.5691425842,113110.36770804533,953,598,355,140200.944386149,172754.1806020067,85364.78873239437,30,30,0,76004.0,76004.0,0.0
88,"Chenango, Delaware & Broome (East) Counties PUMA",361,225,136,53990.31301939058,56842.235555555555,49272.05882352941,90,68,22,69322.47777777778,65412.10294117647,81409.09090909091,271,157,114,48898.450184501846,53130.44585987261,43070.17543859649,0,0,0,#DIV/0!,0.0,0.0
89,"NYC-Queens Community District 5--Ridgewood, Glendale & Middle Village PUMA",10805,6248,4557,55806.0472003702,60007.399167733674,50045.66820276498,3459,1662,1797,66314.15437987857,68743.71841155234,64067.11185308848,6661,4109,2552,51129.37697042486,57066.74860063276,41569.55721003135,685,477,208,48220.29197080292,54899.16142557652,32903.846153846156
90,NYC-Brooklyn Community District 18--Canarsie & Flatlands PUMA,3145,1859,1286,80092.69316375199,76782.7100591716,84877.49766718507,1512,776,736,91070.70105820106,92591.02835051547,89467.74728260869,1384,895,489,72809.33526011561,65943.48603351956,85375.66462167689,249,188,61,53913.6546184739,63132.97872340425,25500.0
91,Monroe County (Central)--Rochester City (West) PUMA,115,41,74,66537.21739130435,60414.634146341465,69929.45945945945,26,26,0,88000.0,88000.0,0.0,67,0,67,74278.80597014926,0.0,74278.80597014926,22,15,7,17595.454545454544,12600.0,28300.0
92,Erie County (Northwest) PUMA,634,451,183,47386.41955835962,46019.93348115299,50754.098360655735,243,169,74,52843.58024691358,43319.4674556213,74594.5945945946,359,265,94,43027.855153203345,45883.018867924526,34978.72340425532,32,17,15,54843.75,75000.0,32000.0
93,NYC-Queens Community District 4--Elmhurst & South Corona PUMA,981,441,540,42753.21100917431,46992.97052154195,39290.74074074074,489,257,232,53398.36400817996,53538.52140077821,53243.10344827586,451,143,308,29552.328159645233,31213.286713286714,28781.16883116883,41,41,0,61000.0,61000.0,0.0
94,"Otsego, Schoharie, Oneida (South) & Herkimer (South) Counties PUMA",315,176,139,110421.58730158731,102397.15909090909,120582.0143884892,176,85,91,168331.81818181818,167548.23529411765,169063.73626373627,83,61,22,33872.2891566265,38119.67213114754,22095.454545454544,56,30,26,41875.0,48500.0,34230.769230769234
95,Suffolk County (Central)--Islip Town (Northwest) PUMA,527,327,200,62120.49335863378,63642.20183486238,59632.5,105,43,62,82380.95238095238,86511.62790697675,79516.12903225806,366,245,121,58192.62295081967,61151.02040816326,52202.479338842975,56,39,17,49803.57142857143,54076.92307692308,40000.0
96,Rensselaer County--Troy City PUMA,560,427,133,81692.875,84779.90632318502,71781.87969924812,271,202,69,106428.11808118082,109000.099009901,98898.55072463768,236,191,45,57846.61016949153,61795.811518324605,41084.444444444445,53,34,19,61399.811320754714,70000.0,46010.0
97,"NYC-Queens Community District 13--Queens Village, Cambria Heights & Rosedale PUMA",465,335,130,56266.666666666664,56764.17910447761,54984.61538461538,211,136,75,59581.99052132702,52588.23529411765,72264.0,200,163,37,53836.0,59871.16564417178,27248.64864864865,54,36,18,52314.81481481482,58472.22222222222,40000.0
98,Erie County (West Central)--Buffalo City (West) PUMA,577,358,219,60453.93414211438,66348.10055865922,50818.72146118721,299,117,182,58702.00668896321,67184.61538461539,53248.9010989011,278,241,37,62338.20143884892,65941.99170124481,38864.86486486487,0,0,0,#DIV/0!,0.0,0.0
99,Suffolk County (Central)--Brookhaven Town (Central) PUMA,1221,886,335,63913.685503685505,54499.94356659142,88810.92537313433,417,192,225,89881.5587529976,89640.36458333333,90087.37777777777,504,414,90,53091.269841269845,43371.9806763285,97800.0,300,280,20,46000.0,46857.142857142855,34000.0
100,Cayuga & Onondaga (South) Counties PUMA,122,30,92,52419.67213114754,44266.666666666664,55078.260869565216,84,18,66,59794.04761904762,52416.666666666664,61806.06060606061,38,12,26,36118.42105263158,32041.666666666668,38000.0,0,0,0,#DIV/0!,0.0,0.0
101,Sullivan & Ulster (West) Counties PUMA,847,412,435,89745.51357733176,125356.91747572816,56017.011494252874,444,134,310,142192.56756756757,317503.7313432836,66412.90322580645,401,276,125,32072.19451371571,32904.166666666664,30235.2,2,2,0,10000.0,10000.0,0.0
102,Chemung (South) & Steuben (East) Counties--Greater Elmira & Greater Corning Cities PUMA,161,113,48,71133.72670807454,67163.98230088495,80479.16666666667,105,78,27,93660.28571428571,82106.79487179487,127037.03703703704,56,35,21,28896.428571428572,33862.857142857145,20619.04761904762,0,0,0,#DIV/0!,0.0,0.0
103,"NYC-Brooklyn Community District 17--East Flatbush, Farragut & Rugby PUMA",164,138,26,28619.51219512195,20823.1884057971,70000.0,32,6,26,60625.0,20000.0,70000.0,97,97,0,22975.25773195876,22975.25773195876,0.0,35,35,0,15000.0,15000.0,0.0
104,Rockland County (North)--New City & Congers PUMA,1068,579,489,74180.94569288389,85359.24006908463,60945.29652351738,501,292,209,81490.71856287424,89996.57534246576,69606.93779904307,554,287,267,68137.90613718411,80641.1149825784,54698.12734082397,13,0,13,50000.0,0.0,50000.0
105,Saratoga County (Outer) PUMA,315,192,123,63590.730158730155,65724.375,60260.16260162602,160,79,81,86003.625,94412.40506329114,77802.46913580247,113,71,42,46623.89380530974,58570.42253521127,26428.571428571428,42,42,0,23857.14285714286,23857.14285714286,0.0
106,Nassau County (Central)--Hempstead Town (North Central)--Meadowbrook Corridor PUMA,375,211,164,42929.066666666666,59181.99052132702,22018.29268292683,74,49,25,121748.64864864865,172967.3469387755,21360.0,229,90,139,24179.039301310044,27333.333333333332,22136.690647482013,72,72,0,21555.555555555555,21555.555555555555,0.0
107,Putnam County PUMA,1678,970,708,75965.67342073898,84858.86597938144,63781.497175141245,612,318,294,104826.63398692811,122251.57232704402,85979.25170068027,898,540,358,63131.95991091314,71698.33333333333,50210.61452513967,168,112,56,39428.57142857143,42142.857142857145,34000.0
108,NYC-Brooklyn Community District 11--Bensonhurst & Bath Beach PUMA,11118,5866,5252,55455.69472926785,59060.15922263893,51429.84006092917,5768,2810,2958,65803.01144244106,73291.98932384342,58688.73563218391,4809,2702,2107,44166.05198585985,46392.59955588453,41310.74513526341,541,354,187,45490.018484288354,42778.53107344633,50622.994652406414
109,Orange County (Southeast) PUMA,1221,858,363,76519.52497952498,87619.39393939394,50283.47107438016,467,263,204,103246.9164882227,142351.3307984791,52832.89215686275,695,544,151,60726.08633093525,64282.42647058824,47913.84105960265,59,51,8,51006.779661016946,54301.96078431373,30000.0
110,Onondaga County (Central)--Syracuse City (Outer) PUMA,1204,702,502,53754.468438538206,65958.2905982906,36688.565737051795,580,356,224,59529.793103448275,63566.06741573034,53115.0,522,296,226,51335.057471264365,72067.56756756757,24180.973451327434,102,50,52,33296.07843137255,46824.0,20288.46153846154
111,"Rockland County (West)--Spring Valley, Suffern Villages & Monsey PUMA",1441,1188,253,56978.77168632894,57589.368686868685,54111.62055335968,444,310,134,95940.54054054055,107747.74193548386,68625.37313432836,636,550,86,40529.71698113208,41440.836363636365,34702.79069767442,361,328,33,38038.531855955676,37261.920731707316,45757.57575757576
112,Monroe County (East) PUMA,927,491,436,76687.70226537217,99172.09775967413,51366.97247706422,433,273,160,100666.97459584296,123963.36996336996,60917.5,452,195,257,57813.49557522124,71089.7435897436,47740.07782101167,42,23,19,32595.238095238095,43000.0,20000.0
113,NYC-Manhattan Community District 10--Central Harlem PUMA,1469,829,640,87743.49897889722,105128.46803377563,65224.53125,1148,597,551,98200.43554006968,124683.58458961474,69506.35208711434,239,150,89,60295.81589958159,73100.0,38715.730337078654,82,82,0,21346.341463414636,21346.341463414636,0.0
114,Nassau County (Southwest)--Hempstead Town (Southwest) & Long Beach City PUMA,1264,742,522,98666.06012658228,107931.94070080863,85495.01915708813,735,402,333,117926.66666666667,132545.0248756219,100279.27927927928,526,337,189,70473.00380228137,76656.97329376855,59446.560846560846,3,3,0,323000.0,323000.0,0.0
115,Nassau County (Southeast)--Oyster Bay Town (South) PUMA,587,359,228,62580.85178875639,75795.93314763231,41772.89473684211,185,121,64,76826.16216216216,88052.39669421487,55601.5625,309,174,135,55142.783171521034,73640.22988505747,31301.62962962963,93,64,29,58956.98924731183,58484.375,60000.0
116,Wayne & Seneca Counties PUMA,234,125,109,54420.94017094017,53665.6,55287.15596330275,139,75,64,56082.73381294964,59242.666666666664,52379.6875,95,50,45,51989.47368421053,45300.0,59422.22222222222,0,0,0,#DIV/0!,0.0,0.0
117,Schenectady County--Schenectady City PUMA,981,733,248,57091.02956167176,64632.605729877214,34800.8064516129,584,405,179,62055.99315068493,73925.18518518518,35201.117318435754,397,328,69,49787.40554156171,53158.53658536585,33762.31884057971,0,0,0,#DIV/0!,0.0,0.0
118,"NYC-Brooklyn Community District 9--Crown Heights South, Prospect Lefferts & Wingate PUMA",917,605,312,53928.46237731734,55119.00826446281,51619.8717948718,546,306,240,51485.16483516483,49898.69281045752,53507.916666666664,356,292,64,58234.550561797754,61191.78082191781,44742.1875,15,7,8,40666.666666666664,30000.0,50000.0
119,"NYC-Manhattan Community District 4 & 5--Chelsea, Clinton & Midtown Business District PUMA",4657,2804,1853,127457.28365900794,138897.1005706134,110146.30329195899,3985,2454,1531,138091.53575909662,148641.67481662592,121180.9928151535,635,313,322,65139.84251968504,72814.05750798722,57680.124223602485,37,37,0,51621.62162162162,51621.62162162162,0.0
120,Westchester County (Northeast) PUMA,1743,1127,616,110731.15318416523,133476.39751552796,69117.6948051948,1142,714,428,138703.85288966724,177889.35574229693,73333.64485981308,483,332,151,60744.306418219465,57844.27710843374,67120.5298013245,118,81,37,44619.49152542373,51982.71604938272,28500.0
121,Nassau County (South Central)--Hempstead Town (Southeast) PUMA,769,477,292,98861.76853055917,99970.85953878406,97050.0,417,237,180,120241.24700239809,131729.95780590718,105114.44444444444,338,240,98,74923.37278106509,68608.75,90387.75510204081,14,0,14,40000.0,0.0,40000.0
122,NYC-Queens Community District 2--Sunnyside & Woodside PUMA,3965,2358,1607,84632.65573770492,93429.08396946565,71725.38892345986,2549,1366,1183,98469.15653197332,114157.23279648609,80354.26880811497,1313,940,373,56585.37699923838,59492.55319148936,49258.98123324397,103,52,51,99747.57281553397,162384.61538461538,35882.35294117647
123,"NYC-Staten Island Community District 3--Tottenville, Great Kills & Annadale PUMA",7177,3949,3228,72068.7278807301,79943.85920486199,62434.62205700124,3833,1875,1958,81878.79467779807,91895.92533333333,72286.29213483146,3066,1889,1177,60524.60534898891,67624.69031233457,49129.481733220055,278,185,93,64127.338129496406,84596.75675675676,23408.602150537634
124,Suffolk County (Central)--Brookhaven Town (West Central) PUMA,1318,900,418,69318.75569044006,76211.66666666667,54477.55980861244,542,272,270,79511.27306273063,97111.76470588235,61780.40740740741,563,462,101,61907.300177619894,65128.78787878788,47171.38613861386,213,166,47,62972.76995305164,72810.84337349398,28225.531914893618
125,NYC-Queens Community District 9--Richmond Hill & Woodhaven PUMA,2279,1252,1027,56435.43220710838,55589.20926517572,57467.049659201555,744,434,310,63065.24193548387,64027.050691244236,61718.709677419356,1471,769,702,53702.65805574439,52110.20806241873,55447.094017094016,64,49,15,42175.0,35453.06122448979,64133.333333333336
126,Suffolk County (Northwest)--Huntington Town (South) PUMA,889,673,216,90834.08323959506,102706.53789004458,53842.59259259259,415,274,141,126167.95180722892,158560.9489051095,63219.85815602837,384,323,61,44533.333333333336,46485.44891640867,34196.72131147541,90,76,14,125455.55555555556,140276.31578947368,45000.0
127,"NYC-Bronx Community District 3 & 6--Belmont, Crotona Park East & East Tremont PUMA",455,323,132,43341.97802197802,40001.238390092876,51516.666666666664,63,22,41,59711.11111111111,58300.0,60468.29268292683,340,263,77,40896.470588235294,39368.0608365019,46116.88311688312,52,38,14,39500.0,33789.47368421053,55000.0
128,Suffolk County (North Central)--Brookhaven Town (North) PUMA,942,655,287,145934.4161358811,159969.3435114504,113903.48432055749,778,535,243,163853.7532133676,179651.06542056074,129073.66255144033,115,71,44,57597.391304347824,74623.94366197183,30122.727272727272,49,49,0,68740.8163265306,68740.8163265306,0.0
129,NYC-Queens Community District 1--Astoria & Long Island City PUMA,9234,5130,4104,53311.152804851634,55764.81091617934,50244.08016569201,4524,2243,2281,62249.56343943413,67998.62683905484,56596.27575624726,4145,2475,1670,45974.224366706876,47583.49898989899,43589.22155688623,565,412,153,35566.37168141593,38309.22330097087,28180.392156862745
130,Nassau County (West Central)--Hempstead Town (Northwest) PUMA,819,576,243,131928.35164835164,155303.29861111112,76521.06995884774,325,241,84,223830.76923076922,276954.356846473,71416.66666666667,494,335,159,71466.23481781376,67787.16417910448,79217.7358490566,0,0,0,#DIV/0!,0.0,0.0
131,Westchester County (Southeast) PUMA,2405,1565,840,147381.10602910604,156022.05111821086,131282.20238095237,1547,1029,518,198506.03749191985,206233.03206997085,183156.4671814672,553,319,234,62261.69981916817,67939.56112852665,54521.36752136752,305,217,88,42400.0,47410.13824884793,30045.454545454544
132,"NYC-Bronx Community District 10--Co-op City, Pelham Bay & Schuylerville PUMA",1114,656,458,58024.968581687615,64984.77896341463,48056.33187772926,509,239,270,69528.6836935167,82527.19665271966,58022.59259259259,468,329,139,53742.94871794872,59443.76899696048,40249.640287769784,137,88,49,29912.518248175184,38056.98863636364,15285.714285714286
133,Suffolk County (South Central)--Brookhaven Town (South) PUMA,825,652,173,61940.72727272727,52841.10429447853,96235.26011560694,329,202,127,85450.45592705168,65257.425742574254,117568.50393700787,419,373,46,38911.45584725537,39105.63002680965,37336.95652173913,77,77,0,86805.1948051948,86805.1948051948,0.0
134,Onondaga County (Central)--Syracuse City PUMA,578,347,231,51021.59169550173,53413.775216138325,47428.13852813853,336,218,118,65607.67857142857,65835.6880733945,65186.4406779661,209,96,113,30140.191387559807,31618.75,28884.070796460175,33,33,0,34757.57575757576,34757.57575757576,0.0
135,Suffolk County (West Central)--Babylon Town (Northwest) PUMA,1081,621,460,51958.97317298797,59118.92109500805,42293.04347826087,314,199,115,61663.53503184713,63912.31155778895,57772.17391304348,498,269,229,50714.4578313253,62640.520446096656,36705.240174672486,269,153,116,42934.944237918215,46692.81045751634,37978.44827586207
136,Suffolk County (Southwest)--Islip Town (South) PUMA,507,309,198,69684.00394477317,81437.8640776699,51340.85858585859,178,110,68,119192.69662921349,132528.18181818182,97620.58823529411,234,155,79,35547.393162393164,45683.87096774193,15659.367088607594,95,44,51,61004.21052631579,79663.63636363637,44905.882352941175
137,Niagara County (North & East) PUMA,188,116,72,54794.20212765958,65277.6724137931,37904.166666666664,61,41,20,62482.13114754098,71497.80487804877,44000.0,127,75,52,51101.574803149604,61877.333333333336,35559.61538461538,0,0,0,#DIV/0!,0.0,0.0
138,NYC-Manhattan Community District 11--East Harlem PUMA,1193,641,552,85797.94635373009,78475.80343213728,94300.65217391304,1062,538,524,92530.08474576271,87250.91078066915,97950.30534351146,52,24,28,27846.153846153848,30000.0,26000.0,79,79,0,33443.037974683546,33443.037974683546,0.0
139,Broome (Outer West) & Tioga Counties PUMA,321,155,166,57931.46417445483,79536.64516129032,37757.951807228914,88,56,32,89631.59090909091,114421.07142857143,46250.0,233,99,134,45958.88412017167,59804.0404040404,35730.0,0,0,0,#DIV/0!,0.0,0.0
140,Albany County (East Central)--Albany City PUMA,535,255,280,47446.542056074766,35662.35294117647,58178.57142857143,297,137,160,41491.24579124579,36675.18248175183,45615.0,223,103,120,55206.27802690583,32227.18446601942,74930.0,15,15,0,50000.0,50000.0,0.0
141,Nassau County (West Central)--Hempstead Town (West Central) PUMA,1031,651,380,72700.7759456838,76995.08448540706,65343.94736842105,564,297,267,81859.5744680851,91952.18855218856,70632.95880149813,387,301,86,66805.42635658915,71215.94684385382,51368.604651162794,80,53,27,36650.0,26000.0,57555.555555555555
142,Nassau County (West Central)--North Hempstead Town (South) PUMA,1613,949,664,78945.69125852449,85698.31401475237,69294.72891566265,625,263,362,83197.184,65862.50950570342,95791.16022099447,719,486,233,82628.4561891516,104694.15637860082,36603.00429184549,269,200,69,59224.163568773234,65622.5,40678.260869565216
143,Nassau County (Central)--Hempstead Town (Northeast) PUMA,1566,899,667,74497.34993614304,82950.44493882092,63104.04797601199,508,269,239,105730.11811023622,120627.8810408922,88962.34309623431,979,614,365,56639.37691521961,68083.95765472313,37387.397260273974,79,16,63,94962.02531645569,20000.0,114000.0
144,Nassau County (Central)--Hempstead Town (East Central) PUMA,1037,692,345,98711.95756991321,100064.59537572254,95998.84057971014,656,376,280,126019.51219512195,141832.44680851063,104785.0,320,255,65,49454.6875,47238.03921568627,58150.769230769234,61,61,0,63442.62295081967,63442.62295081967,0.0
145,"NYC-Bronx Community District 5--Morris Heights, Fordham South & Mount Hope PUMA",89,57,32,28011.23595505618,30263.157894736843,24000.0,43,27,16,20232.558139534885,30444.444444444445,3000.0,21,21,0,25000.0,25000.0,0.0,25,9,16,43920.0,42000.0,45000.0
146,Capital Region,5517,3289,2228,572966.9704150094,666894.832163634,441788.57261337526,3141,1816,1325,719009.9668127686,837160.7118651122,542158.2130893728,2179,1345,834,369828.8002036868,394412.620389587,314665.14198630507,197,128,69,202155.48358966227,198857.14285714287,90180.45454545454
147,Central NY,3453,1813,1640,367378.713671759,459868.51616341656,298012.7176214673,1821,975,846,461190.4572869087,648941.7948830642,382217.4774745029,1428,686,742,223466.99685705354,250717.73724505276,188879.23616697954,204,152,52,145432.96453377593,158960.88610240334,20288.46153846154
148,Finger Lakes,5736,3257,2479,676913.8647548927,795070.1697741962,480006.6114302077,2889,1680,1209,829408.9453662203,895271.3348619437,503371.9686687557,2598,1401,1197,513337.0637880436,523670.5287059484,404071.84519267036,249,176,73,225422.82524493051,227583.63636363638,131500.0
149,Long Island,29423,18836,10587,2146164.7269980866,2396113.9300258127,1721810.8556284902,13519,7900,5619,2866205.108263001,3314065.423026843,2106107.154052482,13050,8821,4229,1477453.6388562722,1644115.1277560373,1179180.7103824015,2854,2115,739,1769434.6947298096,1809460.6392251356,736130.7035571325
150,Mid-Hudson,26596,16598,9998,1482845.5419935132,1719157.9537418608,1152254.2463321036,13854,7783,6071,1979241.3446992647,2483993.0600406555,1470144.7154400724,10450,7035,3415,918454.2950347301,1040309.3201004687,730116.0060609839,2292,1780,512,951246.3176457547,933042.4580203523,406314.04956419766
151,Mohawk Valley,2540,1188,1352,224564.86594152535,234869.0050049628,222054.59245638753,840,352,488,298220.5539804286,370426.18177452404,283761.23576745455,1429,669,760,131142.16616354947,146204.99396504078,111229.59962628123,271,167,104,156633.65921787708,176460.39603960398,60894.8717948718
152,New York City,188331,107592,80739,3881107.174993467,4281135.476401455,3408044.2977536954,110200,57841,52359,4514216.436711848,4980602.420526097,3808913.8676267206,67847,42192,25655,2681158.780387761,2841183.5106301103,2364311.9171077223,10284,7559,2725,2370772.762877257,2518564.6166281025,1373293.0232724624
153,North Country,1445,687,758,174647.6698444367,232385.5203052678,141136.84986584494,599,208,391,265143.23093220335,399810.4360902256,177150.85858585857,652,331,321,115283.34033613445,154308.37345461198,80837.39570027642,194,148,46,96215.98958333334,96415.06399169838,52400.0
154,Southern Tier,2450,1459,991,379325.0953932998,445360.35160809703,302988.1389321206,1329,805,524,482132.8885850423,548153.3032331185,408111.4981968387,1016,557,459,243262.3238177201,298614.4983903408,183058.50681926246,105,97,8,126663.9175257732,66663.9175257732,60000.0
155,Western NY,5173,3300,1873,634772.9972556577,716356.5902956189,524911.3291202036,2538,1361,1177,782904.9009726954,937523.5821888461,605195.0739925297,2350,1682,668,474586.2540776116,533481.4156043706,318095.7201570224,285,257,28,300198.01791102847,322763.77501211455,52000.0
