,puma,Total_geo,Total_geo_m,Total_geo_f,Total_Avg_PINCP_mf_t,Total_Avg_PINCP_m,Total_Avg_PINCP_f,Total_BABS,Total_BABS_m,Total_BABS_f,BABS_Avg_PINCP_mf_t,BABS_Avg_PINCP_m,BABS_Avg_PINCP_f,Total_HS,Total_HS_m,Total_HS_f,HS_Avg_PINCP_mf_t,HS_Avg_PINCP_m,HS_Avg_PINCP_f,Total_HSINC,Total_HSINC_m,Total_HSINC_f,HSINC_Avg_PINCP_mf_t,HSINC_Avg_PINCP_m,HSINC_Avg_PINCP_f
0,Total Geo,3598706,1997986,1600720,84725.80119687466,95940.63507051601,70727.67468389226,1866707,947180,919527,111669.99756040986,133242.62535737664,89448.61461381776,1635722,978527,657195,56080.373704089085,63061.77845475904,45685.44823073821,96277,72279,23998,48985.551585529254,52237.06650617745,39192.39186598883
1,Monroe County (Central)--Rochester City (East) PUMA,21246,11828,9418,56993.183187423514,61259.25938451133,51635.44807814823,13941,7320,6621,62592.21433182699,68823.16393442624,55703.44358858179,7101,4441,2660,46827.92705252781,49323.79193875253,42660.95864661654,204,67,137,28205.882352941175,26000.0,29284.671532846714
2,NYC-Brooklyn Community District 4--Bushwick PUMA,15623,8935,6688,64361.70005760738,62523.11583659765,66818.0023923445,11646,6531,5115,68236.5911042418,64576.028173327206,72910.51808406647,3894,2321,1573,53398.69029275809,57730.719517449375,47006.67514303878,83,83,0,35000.0,35000.0,0.0
3,NYC-Manhattan Community District 10--Central Harlem PUMA,10447,5521,4926,130837.25088542166,162752.60822314798,95066.91230207065,9157,4930,4227,124280.7404171672,141978.3265720081,103639.83676366217,1290,591,699,177378.3100775194,336047.37732656515,43224.63519313305,0,0,0,#DIV/0!,0.0,0.0
4,Ontario & Yates Counties PUMA,43381,24067,19314,69692.48634194693,75297.52939709976,62708.09309309309,18612,9583,9029,92149.15538362347,94029.78503600125,90153.13434488869,22494,12464,10030,51139.45363207967,61144.376604621306,38706.616151545364,2275,2020,255,69414.85714285714,73759.75247524753,34996.470588235294
5,Albany County (Outside Albany City) PUMA,58707,31008,27699,74081.674757695,84932.44162796698,61934.644933030075,26935,13143,13792,92054.3218860219,109951.57193943544,74999.2495649652,29447,16229,13218,60400.442150303934,68965.31147945036,49884.53472537449,2325,1636,689,39147.48387096774,42331.051344743275,31588.24383164006
6,"Otsego, Schoharie, Oneida (South) & Herkimer (South) Counties PUMA",34085,18607,15478,54531.06733167082,60451.62089536196,47413.627083602536,11564,5416,6148,71445.90626080941,89790.56868537667,55285.4163955758,20731,11899,8832,45734.59698036757,47642.88175476931,43163.641304347824,1790,1292,498,47132.42458100559,55429.52012383901,25606.626506024095
7,NYC-Brooklyn Community District 11--Bensonhurst & Bath Beach PUMA,11493,5849,5644,68906.93291568781,75046.14122072149,62544.73777462792,5539,2680,2859,84569.84654269724,95983.46268656716,73870.82896117524,5420,2936,2484,56572.21402214022,58986.444141689375,53718.679549114335,534,233,301,31635.955056179777,36587.98283261803,27802.65780730897
8,"Rockland County (South)--Orangetown, Clarkstown (South) & Ramapo (Southeast) Towns PUMA",22423,13679,8744,109184.18766445167,125386.0143285328,83838.26052150046,14622,8255,6367,127262.87990698947,153526.16353725016,93211.77163499293,7801,5424,2377,75297.93744391744,82558.40892330384,58730.50063104754,0,0,0,#DIV/0!,0.0,0.0
9,Warren & Washington Counties PUMA,41737,22825,18912,52229.93051728682,54021.496604600216,50067.67925126904,12200,4673,7527,73417.2524590164,87439.18681789,64711.991497276475,27479,16537,10942,44156.372502638376,46179.99455765858,41098.00676293182,2058,1615,443,34430.11175898931,37621.529411764706,22795.48532731377
10,Erie County (North Central) PUMA,31737,18289,13448,79981.60412137253,84030.20012029089,74475.5978584176,20314,11022,9292,95250.41252338288,103886.93340591544,85005.92983211364,10893,7199,3694,52448.296153493066,53808.383108765105,49797.70979967515,530,68,462,60641.50943396227,65000.0,60000.0
11,"NYC-Manhattan Community District 4 & 5--Chelsea, Clinton & Midtown Business District PUMA",42125,25895,16230,159670.61649851632,163666.990924889,153294.39248305606,36906,22022,14884,170826.6674795426,177373.16320043593,161140.63356624564,4825,3567,1258,69018.99067357513,69488.59826184469,67687.44038155803,394,306,88,224820.05076142133,275095.09803921566,50000.0
12,Nassau County (Southeast)--Oyster Bay Town (South) PUMA,31450,18078,13372,97655.74181240064,114391.766235203,75029.81827699671,18417,9551,8866,110519.79909865884,130914.86231808188,88548.9837581773,12526,8155,4371,80607.86683697908,98215.90435315757,47756.44932509723,507,372,135,51549.90138067061,44773.655913978495,70222.22222222222
13,Nassau County (Central)--Hempstead Town (Northeast) PUMA,23891,14015,9876,86413.46699593989,97715.00392436676,70375.49210206562,10495,5197,5298,104665.11672224868,127095.29343852222,82662.54435636089,13086,8508,4578,72444.80666360997,81209.51339915374,56156.006989951944,310,310,0,58164.51612903226,58164.51612903226,0.0
14,NYC-Brooklyn Community District 16--Brownsville & Ocean Hill PUMA,1719,956,763,57814.96800465387,57358.1589958159,58387.32634338139,930,543,387,75919.6559139785,83204.41988950277,65698.39793281654,789,413,376,36474.841571609635,23376.271186440677,50862.367021276594,0,0,0,#DIV/0!,0.0,0.0
15,NYC-Brooklyn Community District 2--Brooklyn Heights & Fort Greene PUMA,31245,16148,15097,126770.1446631461,135165.33378746593,117790.51202225608,29196,14667,14529,131505.63673105906,143056.43349014796,119845.12767568312,1781,1213,568,59858.56260527793,57340.97279472383,65235.035211267605,268,268,0,55546.64179104478,55546.64179104478,0.0
16,Onondaga County (Central)--Syracuse City PUMA,18746,8908,9838,58592.02496532594,64246.4077233947,53472.15897540151,8405,3888,4517,75664.17608566329,86148.55709876544,66639.76311711312,9835,4798,5037,45595.5058464667,47871.90704460192,43427.11733174509,506,222,284,27622.332015810276,34558.55855855856,22200.352112676057
17,NYC-Staten Island Community District 2--New Springville & South Beach PUMA,19607,11465,8142,86484.91100117305,97936.97514173572,70358.90813068043,10085,5574,4511,105242.40257808627,119802.691065662,87251.03746397694,9398,5767,3631,67101.51308789104,78263.78012831628,49372.84494629579,124,124,0,30000.0,30000.0,0.0
18,Nassau County (West Central)--Hempstead Town (Northwest) PUMA,20831,12102,8729,120213.4995919543,131877.71442736738,104042.07927597663,14122,7801,6321,145629.18141906246,160952.81374182797,126717.67125454833,6253,3845,2408,69314.9544218775,84844.08322496749,44518.650332225916,456,456,0,31065.13157894737,31065.13157894737,0.0
19,"NYC-Manhattan Community District 9--Hamilton Heights, Manhattanville & West Harlem PUMA",15018,8247,6771,91598.62098814755,113233.74802958651,65247.285482203515,13266,7022,6244,95539.92838836122,121178.91199088578,66706.33728379244,1752,1225,527,61755.365296803655,67690.12244897959,47960.151802656546,0,0,0,#DIV/0!,0.0,0.0
20,Monroe County (Central)--Rochester City (West) PUMA,9935,5583,4352,49562.37544036235,53379.68833960236,44665.30330882353,3787,1426,2361,51432.98125165038,46480.71528751753,54424.057602710716,5451,3689,1762,49355.402678407634,56755.299539170504,33862.65607264472,697,468,229,41017.50358680057,47792.73504273504,27171.17903930131
21,"Chenango, Delaware & Broome (East) Counties PUMA",29440,16565,12875,49512.169157608696,53139.18321762753,44845.64582524272,8241,3255,4986,70151.32629535251,77018.66666666667,65668.13477737666,19934,12527,7407,41514.75067723487,47160.717649876264,31966.07668421763,1265,783,482,41079.95256916996,49517.87994891443,27372.697095435684
22,Dutchess County (North & East) PUMA,34328,19049,15279,75207.10120018644,85974.815475878,61782.51914392303,14425,7192,7233,103761.77954939341,127473.46078976641,80184.50712014378,19270,11460,7810,54676.123508043594,60765.543630017455,45740.81562099872,633,397,236,49505.21327014218,61894.20654911839,28664.406779661018
23,NYC-Brooklyn Community District 10--Bay Ridge & Dyker Heights PUMA,17288,9117,8171,94399.36082832022,94842.00175496326,93905.47301431894,10817,4959,5858,111094.55301839697,118044.02702157693,105211.58245134859,6008,3914,2094,67455.6707723036,68452.09504343383,65593.20439350525,463,244,219,53979.91360691145,46609.42622950819,62191.78082191781
24,NYC-Brooklyn Community District 1--Greenpoint & Williamsburg PUMA,38428,21302,17126,89604.19787654835,95231.29640409352,82604.98890575733,31652,16141,15511,97013.0853026665,107313.11170311629,86294.70956095673,5959,4524,1435,58036.05302903172,59942.471264367814,52025.85365853659,817,637,180,32821.419828641374,39711.77394034537,8437.222222222223
25,NYC-Brooklyn Community District 18--Canarsie & Flatlands PUMA,9411,5548,3863,84844.08670704495,97489.01225666907,66683.57753041678,4989,2547,2442,78930.47504509921,87366.34471927758,70131.88370188371,4077,2656,1421,94354.56463085602,112329.42771084337,60757.6354679803,345,345,0,57971.014492753624,57971.014492753624,0.0
26,Westchester County (Southeast) PUMA,20918,12342,8576,198138.92532746916,254893.12753200452,116462.11054104478,17169,10264,6905,225599.82410157842,291841.6484801247,127134.0622737147,3668,2078,1590,73314.24754634679,72390.90471607314,74520.98113207547,81,0,81,30000.0,0.0,30000.0
27,Nassau County (Central)--Hempstead Town (North Central)--Meadowbrook Corridor PUMA,4286,2837,1449,98722.05786280915,116130.30666196687,64638.4126984127,1558,986,572,132627.59948652118,163964.80730223123,78609.26573426573,2669,1851,818,79041.07905582615,90649.58400864397,52772.93398533007,59,0,59,93700.0,0.0,93700.0
28,Westchester County (Northwest) PUMA,28384,15458,12926,140363.6330326945,168989.02315952905,106130.97942132136,19277,9364,9913,165379.02370700834,221711.57518154636,112166.27156259457,9016,6003,3013,87689.65394853594,88399.98833916376,86274.40756720876,91,91,0,60000.0,60000.0,0.0
29,Monroe County (South) PUMA,47713,25700,22013,84352.71540251085,101916.3887159533,63847.26843229001,30853,16310,14543,102100.43042815934,129622.6167995095,71234.2501547136,15825,8579,7246,53016.32417061611,55668.563935190585,49876.16892078388,1035,811,224,34428.21256038648,33940.44389642417,36194.19642857143
30,Rockland County (North)--New City & Congers PUMA,19413,9652,9761,93864.69324679338,113426.16452548695,74521.66273947341,12087,5054,7033,109702.4199553239,149653.62089434112,80992.99729845017,7195,4467,2728,68136.66435024323,74426.03537049473,57838.04985337243,131,131,0,45640.0,45640.0,0.0
31,"NYC-Bronx Community District 1 & 2--Hunts Point, Longwood & Melrose PUMA",1808,935,873,38151.10619469026,39251.657754010695,36972.39404352807,688,266,422,31966.56976744186,36825.18796992481,28904.028436018958,843,392,451,40816.60735468565,36553.57142857143,44521.95121951219,277,277,0,45400.0,45400.0,0.0
32,Orange County (Southeast) PUMA,28959,18046,10913,87091.33809869125,94599.21589271861,74676.13030330797,14734,7525,7209,109497.30419438034,133486.15681063122,84456.92190317658,13515,9811,3704,64979.931927487974,68506.07685251249,55640.02699784017,710,710,0,43015.49295774648,43015.49295774648,0.0
33,"NYC-Queens Community District 12--Jamaica, Hollis & St. Albans PUMA",332,89,243,63614.4578313253,108168.53932584269,47296.2962962963,196,89,107,81387.75510204081,108168.53932584269,59112.14953271028,136,0,136,38000.0,0.0,38000.0,0,0,0,#DIV/0!,0.0,0.0
34,Nassau County (Northeast)--Oyster Bay Town (North) & Glen Cove City PUMA,22965,13961,9004,174129.91682995865,217161.59300909677,107407.87872056864,16891,10182,6709,204490.21609140962,255561.68729129838,126980.94201818453,5845,3550,2295,85367.8870829769,108109.8309859155,50189.716775599125,229,229,0,200323.1441048035,200323.1441048035,0.0
35,"Rockland County (West)--Spring Valley, Suffern Villages & Monsey PUMA",9803,6393,3410,88073.91716821381,96441.19974972626,72387.1026392962,3807,2393,1414,114092.13816653533,114916.69452569996,112696.69024045262,5104,3412,1692,72637.5078369906,86776.18405627199,44126.18203309693,892,588,304,65356.50224215247,77334.3537414966,42188.81578947369
36,NYC-Queens Community District 2--Sunnyside & Woodside PUMA,17510,10253,7257,90683.26362078812,93000.13517994733,87409.8883836296,13992,7429,6563,100460.18767867352,110165.29627136896,89474.4720402255,3153,2591,562,51520.900729464,46744.268622153606,73542.70462633453,365,233,132,54190.68493150685,60077.25321888412,43800.0
37,Suffolk County (Northwest)--Huntington Town (South) PUMA,26428,16122,10306,112086.60814287876,139714.52611338542,68867.38695905298,14767,9042,5725,124224.8323965599,149768.2824596328,83881.79737991266,11544,6963,4581,96899.49584199584,127686.88496337786,50103.47085789129,117,117,0,78538.46153846153,78538.46153846153,0.0
38,Westchester County (Southwest)--Yonkers City PUMA,21032,10117,10915,82274.7137694941,92700.3133339923,72611.3339441136,12621,5121,7500,95863.75089137153,115751.10330013669,82284.66666666667,7814,4399,3415,60402.614538008704,67417.21300295522,51366.825768667644,597,597,0,81271.94304857621,81271.94304857621,0.0
39,"NYC-Manhattan Community District 1 & 2--Battery Park City, Greenwich Village & Soho PUMA",42911,23357,19554,193569.71452541306,216538.81363188766,166133.42282908867,39835,21272,18563,201252.24902723735,227841.28384731102,170782.931099499,2957,1966,991,94846.695975651,102813.97761953204,79040.76690211907,119,119,0,75000.0,75000.0,0.0
40,NYC-Brooklyn Community District 14--Flatbush & Midwood PUMA,13098,7624,5474,89527.55840586348,104469.46353620147,68716.98392400438,9634,5134,4500,94739.47062487026,113526.76081028438,73305.26,3353,2379,974,76890.45630778407,88915.76292559899,47518.583162217656,111,111,0,18902.702702702703,18902.702702702703,0.0
41,NYC-Queens Community District 9--Richmond Hill & Woodhaven PUMA,6474,3621,2853,79826.32530120482,76109.14112123723,84544.1395022783,3559,2167,1392,93352.48665355437,88210.47531149055,101357.3275862069,2856,1395,1461,63070.42366946779,57357.77777777778,68525.00342231349,59,59,0,75000.0,75000.0,0.0
42,Erie County (West Central)--Buffalo City (West) PUMA,25708,14915,10793,59050.536408899956,61881.21823667449,55138.77698508292,16266,8695,7571,67273.83745235461,72756.56929269695,60977.13247919694,8982,5837,3145,45856.551992874636,48112.215179030325,41670.12718600954,460,383,77,25894.347826086956,24827.67624020888,31200.0
43,Fulton & Montgomery Counties PUMA,31775,17356,14419,48924.042486231316,52480.875777828995,44642.71932866357,8024,3557,4467,68003.81729810569,79171.75991003655,59110.96485336915,21663,12377,9286,43568.74948068135,47101.71527833885,38859.777083782035,2088,1422,666,31163.31417624521,32536.005625879043,28232.432432432433
44,Westchester County (Central)--White Plains City PUMA,30801,16975,13826,152944.16772182722,188895.6583210604,108804.39100245913,25095,13908,11187,169112.73281530186,209982.40293356343,118302.38401716278,5572,2996,2576,82591.00502512563,94554.51935914553,68676.91770186335,134,71,63,50389.55223880597,39200.0,63000.0
45,St. Lawrence County PUMA,28214,15968,12246,52404.359892252076,57788.883391783565,45383.28597092928,9074,4260,4814,71298.62133568438,87216.81924882629,57212.305774823435,18025,10750,7275,44845.60332871012,49445.62976744186,38048.31340206185,1115,958,157,20834.905829596413,20551.89979123173,22561.783439490446
46,Saratoga County (South & Central) PUMA,39121,22214,16907,75807.94637151402,86483.94345907986,61780.82155320282,20719,11031,9688,93081.81427675081,112948.52325265162,70461.08071841454,17938,10892,7046,56714.81547552681,60578.237238340065,50742.57734885041,464,291,173,42608.18965517241,52924.39862542955,25255.49132947977
47,Suffolk County (Central)--Brookhaven Town (West Central) PUMA,30878,18684,12194,72827.92667918907,82902.09698137445,57391.99114318517,10266,6186,4080,91560.44613286576,104388.64371160686,72110.63480392157,20156,12234,7922,63944.7846794999,72843.76573483733,50202.02600353446,456,264,192,43750.21929824561,45545.454545454544,41281.770833333336
48,Suffolk County (North Central)--Brookhaven Town (North) PUMA,27943,16802,11141,100796.86790967327,110105.42673491251,86758.4148640158,14382,7816,6566,117048.41329439577,130153.2088024565,101448.7968321657,12973,8476,4497,83249.06343945117,93441.17508258612,64038.84812096954,588,510,78,90453.23129251701,79816.66666666667,160000.0
49,Niagara County (Southwest)--Greater Niagara Falls & North Tonawanda Area PUMA,29463,16422,13041,58754.70827817941,59088.253562294485,58334.688290775244,9175,4541,4634,86759.66430517711,80160.3985906188,93226.48899438929,19304,11181,8123,45002.33889349358,49071.46319649405,39401.34433091222,984,700,284,67423.67886178862,82387.0,30542.25352112676
50,Suffolk County (Central)--Islip Town (East) PUMA,27218,15664,11554,88498.0178558307,99856.94267109295,73098.48537303098,12745,6798,5947,99414.66849744998,116760.56928508385,79586.61510005045,14083,8669,5414,80103.46517077327,87747.00657515285,67864.48097524936,390,197,193,34876.92307692308,49451.77664974619,20000.0
51,"NYC-Brooklyn Community District 9--Crown Heights South, Prospect Lefferts & Wingate PUMA",8162,4418,3744,75242.75545209508,87415.19918515165,60879.01175213675,6926,3413,3513,78980.99480219463,95936.3463228831,62508.289211500145,1076,845,231,28285.68773234201,26149.112426035503,36101.2987012987,160,160,0,229210.0,229210.0,0.0
52,Westchester County (Northeast) PUMA,33842,19732,14110,158488.08728798534,198749.68933711736,102184.61941885187,24270,13966,10304,192455.2546353523,246622.94644135758,119036.58385093168,9508,5766,3742,72534.37315944467,82794.45022545959,56724.75146980224,64,0,64,47000.0,0.0,47000.0
53,Chautauqua County PUMA,34427,19150,15277,48157.31112208441,52006.00574412532,43332.90174772534,9407,4003,5404,59312.20261507388,65670.94179365475,54601.98186528497,23015,13813,9202,44990.6348033891,49157.563889089986,38735.7128885025,2005,1334,671,32170.77306733167,40495.35232383808,15620.86438152012
54,Erie County (West Central)--Buffalo City (East) PUMA,15774,8251,7523,47877.985926207686,56632.15610229063,38276.67552837964,6372,3291,3081,60093.94224733208,74490.00303859009,44716.650438169425,8661,4637,4024,40580.01962821845,45462.99762777658,34953.18836978131,741,323,418,28131.174089068827,35026.006191950466,22803.34928229665
55,Cayuga & Onondaga (South) Counties PUMA,37300,21610,15690,68459.30643431636,77707.50439611291,55721.6673040153,13255,7022,6233,98739.35646925689,113089.51438336656,82572.69372693727,22112,13162,8950,51639.24294500724,60520.08661297675,38578.945251396646,1933,1426,507,53230.73978272116,62117.26507713885,28236.29191321499
56,Oneida County (Central)--Greater Utica & Rome Cities PUMA,38301,20203,18098,56651.57071616929,66948.31609166955,45157.19858547906,14277,6465,7812,79614.78251733558,105823.99381283837,57924.74782386073,22782,12878,9904,43050.8849091388,48736.50489206398,35657.9715266559,1242,860,382,42162.882447665055,47413.95348837209,30341.09947643979
57,Suffolk County (Southwest)--Babylon Town (Southeast) PUMA,25265,14408,10857,75449.11221056798,86476.95794003332,60814.38795247306,10734,5439,5295,88165.73504751257,104887.88196359624,70988.82152974504,14216,8739,5477,66107.36634777715,75435.55555555556,51223.48000730327,315,230,85,63709.52380952381,70623.91304347826,45000.0
58,"NYC-Manhattan Community District 6--Murray Hill, Gramercy & Stuyvesant Town PUMA",44255,23183,21072,164993.79256581177,175667.21261269035,153251.1057327259,42203,22193,20010,167100.77245693436,180475.46929211915,152266.95702148924,2052,990,1062,121660.03411306044,67879.69696969698,171794.24670433145,0,0,0,#DIV/0!,0.0,0.0
59,NYC-Manhattan Community District 11--East Harlem PUMA,5978,3397,2581,140695.6925393108,146282.83191050927,133342.1425803952,5003,2650,2353,130242.3286028383,121943.88679245283,139588.21504462388,975,747,228,194334.85128205127,232625.80990629183,68881.57894736843,0,0,0,#DIV/0!,0.0,0.0
60,Schenectady County--Schenectady City PUMA,41524,21879,19645,59685.95197957807,68245.34850770145,50153.19368796131,15216,7903,7313,81790.95688748686,97810.47703403771,64479.00998222344,24236,12373,11863,48510.80912691863,54765.96460033945,41986.7394419624,2072,1603,469,28069.64285714286,26528.072364316904,33338.59275053305
61,"Clinton, Franklin, Essex & Hamilton Counties PUMA",51851,28023,23828,49557.71830822935,52610.00328301752,45968.0682390465,13038,4889,8149,62976.96747967479,75919.81427694825,55211.89471100749,36157,20890,15267,45672.456509113035,48663.019147917665,41580.43754503177,2656,2244,412,36575.50451807229,38568.48484848485,25720.533980582524
62,Onondaga County (Central)--Syracuse City (Outer) PUMA,48469,25886,22583,72695.13235263777,87467.59715676427,55762.040030111144,23985,12784,11201,98588.66833437564,123975.52643929912,69613.97018123382,22953,12281,10672,48462.47375070797,53439.72722091035,42734.80790854573,1531,821,710,30340.953625081645,28002.19244823386,33045.35211267605
63,"NYC-Queens Community District 11--Bayside, Douglaston & Little Neck PUMA",11440,6590,4850,77107.29895104896,83921.41122913505,67848.53608247422,6691,3470,3221,90182.80974443282,100336.80115273775,79243.86215461037,4577,3038,1539,57582.438278348265,64737.78801843318,43457.71280051982,172,82,90,88020.3488372093,100000.0,77105.55555555556
64,"NYC-Staten Island Community District 3--Tottenville, Great Kills & Annadale PUMA",37654,20963,16691,84306.3201784671,102405.97624385823,61574.12377928225,19091,8812,10279,90412.53260698759,113726.45937358149,70425.92664656095,18163,11751,6412,78550.06992236966,95556.06501574334,47383.90517779164,400,400,0,54249.0,54249.0,0.0
65,Onondaga County (North) PUMA,47952,26149,21803,64138.1965298632,70001.97521893763,57105.588680456814,22819,10965,11854,75980.56312721854,86078.77792977657,66639.67184072887,24183,14693,9490,52352.03779514535,56692.08806914857,45632.50579557429,950,491,459,79710.52631578948,109268.83910386966,48091.50326797386
66,Ulster County (East) PUMA,43091,23635,19456,65212.06562855353,69789.88830124815,59650.96165707237,17389,7580,9809,87151.54810512393,102911.43667546174,74972.94117647059,24070,14764,9306,50366.246364769424,53936.73936602547,44701.6473243069,1632,1291,341,50403.98284313725,56617.58326878389,26879.76539589443
67,Oswego County PUMA,37093,20602,16491,55761.42129242714,61609.6301329968,48455.32714814141,9234,3737,5497,73506.6006064544,80113.52154134332,69015.04820811351,24637,14261,10376,51371.14380809352,60626.113175794126,38650.91268311488,3222,2604,618,38475.35071384234,40441.00230414746,30192.89644012945
68,Niagara County (North & East) PUMA,33330,18288,15042,59369.93129312931,67120.91699475066,49946.31564951469,10687,4547,6140,75983.10096378777,105620.98746426216,54034.65309446254,22149,13361,8788,51765.72350896203,54663.371005164285,47360.230996813836,494,380,114,40909.71659919028,44451.05263157895,29105.263157894737
69,Broome (Outer West) & Tioga Counties PUMA,35723,19723,16000,61677.2124401646,68904.79693758556,52767.859375,11037,5621,5416,74394.80927788348,88731.74702010318,59515.206794682425,23218,13109,10109,57132.580325609444,62191.51422686704,50572.33059649817,1468,993,475,37939.57765667575,45296.67673716012,22559.36842105263
70,"NYC-Bronx Community District 4--Concourse, Highbridge & Mount Eden PUMA",529,373,156,103676.74858223062,102265.41554959785,107051.28205128205,529,373,156,103676.74858223062,102265.41554959785,107051.28205128205,0,0,0,#DIV/0!,0.0,0.0,0,0,0,#DIV/0!,0.0,0.0
71,Suffolk County (Southwest)--Islip Town (South) PUMA,28294,16610,11684,84186.41196013289,97226.35099337748,65648.80605956864,15225,8046,7179,94946.18587848933,115200.97936863037,72245.24307006547,12697,8235,4462,68892.78254705836,76214.88888888889,55379.21335723891,372,329,43,165814.51612903227,183565.34954407296,30000.0
72,Erie County (Central) PUMA,48453,26086,22367,51978.09134625307,56814.47366403435,46337.555327044305,15317,6371,8946,63996.719331461776,78750.34374509496,53489.75072658171,31921,18792,13129,46991.41975502021,50584.334823329074,41848.753903572244,1215,923,292,31476.213991769546,32246.045503791982,29042.80821917808
73,"NYC-Bronx Community District 8--Riverdale, Fieldston & Kingsbridge PUMA",8494,4453,4041,87887.54885801743,87327.42869975297,88504.77604553329,6555,3175,3380,92940.98093058734,87440.70236220473,98107.66272189349,1809,1148,661,74756.61138750691,95113.94599303136,39400.75642965204,130,130,0,15800.0,15800.0,0.0
74,Chemung (South) & Steuben (East) Counties--Greater Elmira & Greater Corning Cities PUMA,28886,15994,12892,56638.252786817146,64178.06302363386,47284.25612783121,10531,5642,4889,73197.17310796696,85276.40198511166,59257.51073839231,17283,9607,7676,47690.16721633975,53351.04611220985,40605.218863991664,1072,745,327,38231.32462686567,44014.73825503356,25055.045871559632
75,Nassau County (South Central)--Hempstead Town (Southeast) PUMA,24846,13819,11027,111260.1919826129,124366.63362037775,94835.24258637888,15422,7914,7508,137267.03994293866,159444.81804397271,113889.98401704848,9091,5849,3242,68504.18435815642,77784.54778594631,51761.17211597779,333,56,277,74074.77477477478,32400.0,82500.0
76,"NYC-Queens Community District 13--Queens Village, Cambria Heights & Rosedale PUMA",5684,2371,3313,102838.6593947924,96419.09742724588,107432.91880470872,4022,1322,2700,117542.26752859274,112880.6278366112,119824.74444444444,1662,1049,613,67256.28158844766,75673.48903717827,52852.283849918436,0,0,0,#DIV/0!,0.0,0.0
77,Cattaraugus & Allegany Counties PUMA,36092,20886,15206,48956.578743211794,50918.71397108111,46261.51387610154,8457,3572,4885,72159.34728627173,76270.80347144457,69152.97645854657,25837,15706,10131,42556.89669853311,47163.96600025468,35414.597769223175,1798,1608,190,31783.481646273638,31275.932835820895,36078.94736842105
78,"NYC-Queens Community District 7--Flushing, Murray Hill & Whitestone PUMA",14475,8337,6138,82132.90500863559,87666.66666666667,74616.61779081135,6688,3557,3131,101980.13157894737,116807.8549339331,85134.96646438837,7706,4699,3007,64614.67427978199,65222.698446477974,63664.522780179585,81,81,0,110000.0,110000.0,0.0
79,Jefferson & Lewis Counties PUMA,37872,22821,15051,49602.442173637515,53773.82630033741,43277.60281708856,10816,5076,5740,64788.25813609467,78559.71631205674,52609.87456445993,25624,16716,8908,44149.85911645333,47910.114261785115,37093.682083520434,1432,1029,403,32470.60055865922,26761.807580174926,47047.14640198511
80,"NYC-Brooklyn Community District 6--Park Slope, Carroll Gardens & Red Hook PUMA",31939,17279,14660,125563.79291774947,145767.65160020834,101750.5272851296,29246,15201,14045,130557.05334062778,156108.00947306099,102903.07796368815,2516,1901,615,74647.21780604134,74394.21357180431,75429.26829268293,177,177,0,24282.485875706214,24282.485875706214,0.0
81,NYC-Queens Community District 1--Astoria & Long Island City PUMA,32087,18114,13973,71524.2073113722,79512.28938942254,61168.79911257425,24928,13385,11543,74987.40893774069,84809.14904744117,63598.34271853071,6579,4226,2353,58445.72275421797,63544.356365357315,49288.55078623034,580,503,77,71028.79310344828,72717.09741550696,60000.0
82,Saratoga County (Outer) PUMA,42195,23663,18532,71329.54686574239,80433.79326374509,59704.58558169653,17950,9678,8272,97972.46295264624,116525.96714197149,76265.40135396518,22205,12081,10124,53176.41251970277,58955.32323483155,46280.42078229949,2040,1904,136,34491.313725490196,33260.12605042017,51727.94117647059
83,Dutchess County (Southwest) PUMA,37718,20825,16893,80540.68020573731,89285.90953181272,69759.91890132007,18235,8970,9265,105116.235810255,122340.17502787067,88440.71127900701,18718,11090,7628,57873.538625921574,65304.39819657349,47070.1520713162,765,765,0,49361.986928104576,49361.986928104576,0.0
84,Erie County (Northwest) PUMA,37333,19606,17727,58707.52604933973,65326.49954095685,51386.964517402834,17553,8721,8832,69483.97595852561,82849.58949661737,56286.340579710144,18510,10256,8254,50295.139924365205,52643.84555382215,47376.757935546404,1270,629,641,32372.283464566928,29165.02384737679,35519.5007800312
85,Genesee & Orleans Counties PUMA,30992,17123,13869,48260.917849767684,53049.92968521871,42348.28898983344,7034,2664,4370,68163.61529712823,77295.29654654655,62596.84210526316,22530,13443,9087,43367.833821571236,49814.86840734955,33830.309232970176,1428,1016,412,27424.50980392157,32281.496062992126,15447.087378640777
86,Erie County (Northeast) PUMA,41394,24113,17281,74716.56109581099,86431.96118276448,58369.5069729761,21300,12745,8555,90894.00798122065,101065.76069046685,75740.41496201052,19896,11276,8620,57905.15480498593,70490.8442710181,41441.55452436195,198,92,106,23707.070707070707,13000.0,33000.0
87,"NYC-Queens Community District 5--Ridgewood, Glendale & Middle Village PUMA",23787,13363,10424,68863.60196746122,76227.68016164035,59423.2549884881,11662,5943,5719,73962.03910135482,87745.92125189299,59638.27417380661,11429,6820,4609,63137.29985125558,69509.60117302052,53708.118897808636,696,600,96,77466.9540229885,38501.666666666664,321000.0
88,NYC-Brooklyn Community District 3--Bedford-Stuyvesant PUMA,12992,7556,5436,80756.5625,91970.88803599788,65168.732523914645,9742,5489,4253,87632.24799835762,97798.07433047914,74512.0456148601,2932,1749,1183,47812.414733969985,58792.73870783305,31578.613693998308,318,318,0,173867.61006289307,173867.61006289307,0.0
89,Nassau County (West Central)--Hempstead Town (West Central) PUMA,15402,7723,7679,85338.96312167251,92214.73520652596,78423.79346269046,7925,3521,4404,103162.34826498423,114302.35728486226,94255.90599455041,7431,4156,3275,66475.18503566142,73836.33301251203,57133.8320610687,46,46,0,62000.0,62000.0,0.0
90,Suffolk County (South Central)--Brookhaven Town (South) PUMA,30476,17773,12703,82448.09850374065,101396.13908737974,55937.54782334882,11030,6474,4556,109811.85131459656,136541.6512202657,71829.25153643548,18638,10846,7792,66472.06406266766,82048.02968836438,44791.247433264885,808,453,355,77422.27722772278,62362.03090507726,96640.0
91,Orange County (Northeast)--Greater Newburgh City PUMA,25788,14608,11180,66573.18287575616,71157.71358159912,60582.94812164579,10959,4694,6265,81146.74514098001,92842.89092458457,72383.5035913807,13205,8371,4834,57256.468004543734,64277.738621431134,45097.7885808854,1624,1543,81,43984.23645320197,42513.54504212573,72000.0
92,Sullivan & Ulster (West) Counties PUMA,22630,13639,8991,61557.352629253204,69512.86018036513,49489.15471026582,7355,3386,3969,82222.64174031271,105257.93857058477,62570.9624590577,14037,9295,4742,53407.4346370307,61136.365788058094,38257.62125685365,1238,958,280,31191.599353796446,24446.764091858036,54268.57142857143
93,"NYC-Staten Island Community District 1--Port Richmond, Stapleton & Mariner's Harbor PUMA",20878,12112,8766,78189.5890410959,91627.5858652576,59622.28154232261,10380,5975,4405,92767.38921001926,110031.96652719665,69349.48921679909,10091,5822,4269,64019.49658111188,75111.01339745792,48893.04755211993,407,315,92,57729.72972972973,47796.8253968254,91739.13043478261
94,Wayne & Seneca Counties PUMA,36991,20775,16216,52014.13208618313,59376.94632972322,42581.32091761223,10043,5118,4925,75576.3964950712,92575.05080109417,57911.60203045685,24320,13393,10927,42694.24383223684,48281.15806764728,35846.47753271712,2628,2264,364,48218.036529680365,49967.93286219081,37334.06593406593
95,Albany County (East Central)--Albany City PUMA,22093,11384,10709,66014.81645770154,64575.26440618412,67545.10505182557,14957,7431,7526,71668.5050478037,73363.47059615125,69994.9348923731,7067,3884,3183,54332.235743597,48251.09680741504,61752.639019792645,69,69,0,37008.69565217391,37008.69565217391,0.0
96,Nassau County (Northwest)--North Hempstead Town (North) PUMA,20952,12414,8538,159777.7233676976,202934.3499275012,97029.26212227688,14621,8874,5747,197812.17837357227,244496.21591165202,125726.89055159214,6078,3287,2791,72436.82132280356,101730.33160937025,37937.44177714081,253,253,0,60000.0,60000.0,0.0
97,Rensselaer County--Troy City PUMA,49868,27633,22235,68507.38690141976,79616.66196214671,54701.10861254779,20242,12095,8147,91909.06679181899,106094.77304671351,70849.03031790843,28407,14621,13786,52373.76139683881,58498.662198208054,45877.88335993036,1219,917,302,55883.18293683347,67090.51254089423,21852.98013245033
98,Tompkins County PUMA,21456,11694,9762,64168.2769388516,72575.31811185223,54097.39602540463,11647,6067,5580,69498.64772044303,74051.0351079611,64548.94623655914,9372,5540,3832,57665.47161758429,71702.37184115524,37372.04070981211,437,87,350,61562.9290617849,25252.873563218393,70588.57142857143
99,Suffolk County (West Central)--Babylon Town (Northwest) PUMA,16192,9024,7168,75006.259263834,85023.36214539007,62395.44224330357,6957,3479,3478,88263.45120022999,100083.56711698764,76439.9367452559,8874,5184,3690,63061.69934640523,72958.54359567902,49157.840108401084,361,361,0,113138.50415512465,113138.50415512465,0.0
100,NYC-Queens Community District 3--Jackson Heights & North Corona PUMA,5987,3712,2275,77100.18039084683,74444.296875,81433.64835164836,4272,2464,1808,92268.2186329588,94540.29220779221,89171.76438053098,1654,1248,406,40177.11608222491,34767.58814102564,56805.418719211826,61,0,61,16000.0,0.0,16000.0
101,NYC-Queens Community District 4--Elmhurst & South Corona PUMA,1453,878,575,56020.027529249826,58935.19362186788,51568.69565217391,752,420,332,63492.42021276596,68938.80952380953,56602.409638554214,636,393,243,48822.012578616355,51376.08142493639,44691.358024691355,65,65,0,40000.0,40000.0,0.0
102,Columbia & Greene Counties PUMA,30079,15291,14788,58880.66458326407,61946.58230331568,55710.46253719232,8671,2912,5759,91920.66658978203,106696.16758241758,84449.53290501823,20212,11225,8987,45851.92014644766,52700.89532293987,37297.369533771,1196,1154,42,39522.073578595315,38958.75216637782,55000.0
103,Madison & Cortland Counties PUMA,36753,21224,15529,52253.92566593203,56378.36741424802,46616.91416060274,12165,5290,6875,70330.00328812166,86664.45746691871,57761.383272727275,22445,14377,8068,43921.48540877701,47329.53954232454,37848.40728805156,2143,1557,586,36913.81241250583,37034.489402697494,36593.17406143345
104,NYC-Queens Community District 6--Forest Hills & Rego Park PUMA,12646,7528,5118,101985.97896568084,111225.22449521786,88396.09222352481,9940,5768,4172,107002.42354124748,114440.37621359223,96719.07957813998,2489,1543,946,84305.18280433909,104300.97213220998,51690.48625792812,217,217,0,75000.0,75000.0,0.0
105,NYC-Brooklyn Community District 5--East New York & Starrett City PUMA,1197,856,341,71321.38680033416,76756.65887850468,57677.41935483871,350,133,217,103628.57142857143,143473.68421052632,79207.3732718894,484,360,124,92619.8347107438,117633.33333333333,20000.0,363,363,0,11773.2782369146,11773.2782369146,0.0
106,"NYC-Bronx Community District 5--Morris Heights, Fordham South & Mount Hope PUMA",226,140,86,40848.67256637168,38000.0,45486.04651162791,36,0,36,25300.0,0.0,25300.0,78,28,50,63602.5641025641,70000.0,60020.0,112,112,0,30000.0,30000.0,0.0
107,NYC-Brooklyn Community District 8--Crown Heights North & Prospect Heights PUMA,17354,9200,8154,99297.91805923707,114076.35108695652,82623.69879813588,14416,7241,7175,107651.89997225306,126551.29540118769,88578.65644599304,2364,1518,846,57745.46531302876,66277.66798418973,42435.91016548463,574,441,133,60620.20905923345,73775.51020408163,17000.0
108,"Steuben (North & West), Schuyler & Chemung (North) Counties PUMA",28138,15699,12439,46652.40208970076,51295.53092553666,40792.40694589597,6031,2554,3477,60175.07710164152,72518.05403288959,51108.65113603682,20596,12019,8577,42925.84433870654,46792.29802812214,37507.760289145386,1511,1126,385,43473.66644606221,51226.28774422735,20799.766233766233
109,Herkimer (North & Central) & Oneida (Outer) Counties PUMA,34449,20870,13579,49493.01442712415,56206.38878773359,39175.014360409456,8318,4523,3795,73831.43183457562,93566.29449480433,50310.80368906456,24423,15315,9108,42207.46853375916,46212.091674828596,35473.73956960913,1708,1032,676,35141.686182669786,40783.72093023256,26528.402366863906
110,Livingston & Wyoming Counties PUMA,32476,18876,13600,51960.34487005789,56098.2745285018,46217.14191176471,8875,3896,4979,65023.97521126761,71952.90554414784,59602.181160875676,22710,14207,8503,47291.586085424926,52381.667487858096,38786.965776784666,891,773,118,40835.53310886644,44496.972833117725,16850.0
111,Putnam County PUMA,25826,13576,12250,89353.77216758305,109816.97333529759,66675.53387755102,12976,6408,6568,105213.63671393342,137221.40917602996,73985.59074299634,12641,6959,5682,73914.5138833953,86724.44891507401,58225.612460401266,209,209,0,38492.82296650718,38492.82296650718,0.0
112,"NYC-Brooklyn Community District 17--East Flatbush, Farragut & Rugby PUMA",1246,805,441,66027.28731942215,66901.86335403727,64430.839002267574,734,530,204,64472.75204359673,64007.54716981132,65681.37254901961,512,275,237,68255.859375,72480.0,63354.43037974684,0,0,0,#DIV/0!,0.0,0.0
113,Suffolk County (Northwest)--Huntington Town (North) PUMA,22469,11988,10481,107384.57207708398,131768.05972639305,79495.1292815571,15663,7898,7765,124922.28819510949,160703.74145353254,88527.96522858982,6337,3773,2564,69468.2894113934,78585.67452955208,56051.79407176287,469,317,152,33999.147121535185,43828.39116719243,13500.0
114,"NYC-Bronx Community District 12--Wakefield, Williamsbridge & Woodlawn PUMA",2448,1576,872,70896.87091503268,75621.38324873097,62358.07339449541,1309,720,589,71504.96562261268,74221.38888888889,68184.38030560271,952,669,283,72915.06302521008,82510.46337817638,50231.94346289753,187,187,0,56365.77540106952,56365.77540106952,0.0
115,NYC-Manhattan Community District 3--Chinatown & Lower East Side PUMA,20621,12309,8312,99281.61097909897,109005.72264196929,84881.45572666025,18729,10769,7960,104904.39585669283,119461.3399572848,85210.45979899497,1892,1540,352,43621.390063424944,35891.08441558442,77441.47727272728,0,0,0,#DIV/0!,0.0,0.0
116,Nassau County (East Central)--Oyster Bay Town (Central) PUMA,21544,11331,10213,112128.51559598961,131515.25990645133,90619.53686478018,14113,6556,7557,128575.5353220435,158421.13483831604,102683.2830488289,7315,4775,2540,81413.83595352016,94573.91623036649,56673.92125984252,116,0,116,48000.0,0.0,48000.0
117,Westchester County (South Central)--New Rochelle & Mount Vernon Cities PUMA,27166,15075,12091,144695.01361996614,175138.4039800995,106738.34256885287,20410,10342,10068,169474.19794218522,221387.78959582286,116147.78108859753,6594,4571,2023,70913.61237488626,75783.61846423103,59909.757785467125,162,162,0,26000.0,26000.0,0.0
118,Orange County (Northwest) PUMA,22117,12724,9393,64859.62879233169,73327.18248978308,53389.26221654424,6721,2915,3806,87325.25368248773,113293.217838765,67436.49500788229,14087,8974,5113,56721.54326684177,64074.47515043459,43816.16272247213,1309,835,474,37090.14514896868,33246.706586826345,43860.759493670885
119,Nassau County (Central)--Hempstead Town (East Central) PUMA,30692,18649,12043,105296.53101785481,119958.4202906322,82592.09084115253,17710,9253,8457,123554.9734613213,150781.37144709824,93765.9394584368,12714,9128,3586,80951.84442347019,90659.92002629272,56240.37925264919,268,268,0,53659.701492537315,53659.701492537315,0.0
120,Monroe County (North & West) PUMA,34477,17825,16652,56522.92078777156,63461.06591865358,49096.038914244535,13709,6231,7478,67460.36910059085,78380.1316000642,58361.54051885531,19402,10581,8821,51351.55344809814,58897.28759096494,42300.2652760458,1366,1013,353,20207.686676427526,19362.981243830207,22631.72804532578
121,Suffolk County (Northwest)--Smithtown Town PUMA,36599,22710,13889,108912.1057952403,120584.08498458829,89827.1718626251,23192,13872,9320,131502.38056226284,149198.44434832755,105163.3465665236,13250,8747,4503,69912.52452830189,75934.57756945239,58214.79013990673,157,91,66,63248.4076433121,50373.62637362637,81000.0
122,Broome County (West Central)--Greater Binghamton City & Greater Johnson City Village PUMA,24354,12562,11792,54468.39122936684,61686.196465530964,46779.27408412483,9168,4905,4263,75742.77050610821,87799.03975535168,61870.84916725311,13760,6656,7104,42330.39098837209,45965.431189903844,38924.58755630631,1426,1001,425,34815.77840112202,38263.53646353646,26695.29411764706
123,"NYC-Brooklyn Community District 12--Borough Park, Kensington & Ocean Parkway PUMA",12831,9122,3709,63085.77429662536,64121.88884016663,60537.53033162578,4833,2956,1877,71360.85661080075,72167.63193504736,70090.30367607885,6153,4462,1691,61298.6754428734,64766.77498879426,52147.48669426375,1845,1704,141,47368.9972899729,48475.93896713615,33991.48936170213
124,Suffolk County (Central)--Brookhaven Town (Central) PUMA,32116,16943,15173,69106.01849545397,79230.60201853272,57800.355895340406,11157,5306,5851,87447.28869767858,106208.73916321146,70433.40112801231,19869,10937,8932,60151.305551361416,67693.56496296973,50916.006493506495,1090,700,390,44599.266055045875,54994.28571428572,25941.53846153846
125,NYC-Queens Community District 10--Howard Beach & Ozone Park PUMA,8412,4394,4018,74437.53090822634,66438.52981338189,83185.06968641115,2651,787,1864,80086.76348547717,91048.28462515883,75458.69635193133,5310,3363,1947,60898.32391713747,61516.473386856975,59830.61119671289,451,244,207,200639.46784922393,54901.639344262294,372427.0531400966
126,Erie County (South) PUMA,55996,29911,26085,62226.69333523823,72336.95028584801,50633.521180755226,22157,11088,11069,81284.78720043327,96435.88383838384,66107.6836209233,33232,18519,14713,49886.967079922964,58254.21675036449,39355.253857133146,607,304,303,42133.7726523888,51248.68421052631,32988.77887788779
127,"NYC-Bronx Community District 11--Pelham Parkway, Morris Park & Laconia PUMA",8001,4303,3698,63143.653293338335,66424.91285149896,59325.5732828556,3762,1526,2236,79837.01222753854,97190.62909567497,67993.71198568873,4104,2642,1462,47944.81725146199,48983.1566994701,46068.41997264022,135,135,0,60000.0,60000.0,0.0
128,"NYC-Queens Community District 14--Far Rockaway, Breezy Point & Broad Channel PUMA",11919,6477,5442,95918.03842604245,117421.78477690289,70324.54979786843,7430,3164,4266,110194.14535666218,162180.81542351455,71636.75574308485,3963,2950,1013,74714.0550088317,75400.94915254238,72713.7216189536,526,363,163,54016.73003802281,68782.36914600551,21133.742331288344
129,"NYC-Bronx Community District 10--Co-op City, Pelham Bay & Schuylerville PUMA",9057,5012,4045,71617.52235839682,76214.49521149242,65921.59456118665,4847,2194,2653,81126.8619764803,95110.02734731085,69562.94760648323,4042,2650,1392,61787.80306778823,63261.8679245283,58981.57327586207,168,168,0,33760.119047619046,33760.119047619046,0.0
130,Nassau County (West Central)--North Hempstead Town (South) PUMA,17425,9741,7684,92831.89555236729,105911.43619751565,76250.97345132743,9737,4519,5218,111786.73924206634,141873.40119495464,85730.46761211193,7562,5096,2466,68945.60962708278,75116.9152276295,56192.57907542579,126,126,0,61600.0,61600.0,0.0
131,Monroe County (Central)--Greece & Gates Towns PUMA,38756,20721,18035,50206.680772009495,53302.47333622895,46649.823676185195,10050,4418,5632,68467.90845771144,82372.58261656859,57560.44211647727,27034,15126,11908,44551.56987497226,46669.124685971175,41861.770238495126,1672,1177,495,31878.28947368421,29431.860662701783,37695.35353535353
132,"NYC-Manhattan Community District 12--Washington Heights, Inwood & Marble Hill PUMA",18990,8989,10001,80311.96577145866,91323.90588497052,70414.32256774322,16338,7465,8873,83063.59591137226,94127.66108506364,73755.21695029867,1995,1171,824,64404.51127819549,78371.13578138343,44556.31067961165,657,353,304,60189.04109589041,75000.0,42990.78947368421
133,"NYC-Brooklyn Community District 15--Sheepshead Bay, Gerritsen Beach & Homecrest PUMA",11711,5838,5873,74642.36358978738,84109.79787598492,65231.35024689256,7387,2599,4788,75662.24719101124,88040.63101192766,68943.0701754386,4148,3063,1085,70887.34329797493,78692.91544237676,48851.88940092166,176,176,0,120335.22727272728,120335.22727272728,0.0
134,"NYC-Bronx Community District 3 & 6--Belmont, Crotona Park East & East Tremont PUMA",708,552,156,148786.1581920904,188856.15942028986,7000.0,552,552,0,188856.15942028986,188856.15942028986,0.0,156,0,156,7000.0,0.0,7000.0,0,0,0,#DIV/0!,0.0,0.0
135,Nassau County (Southwest)--Hempstead Town (Southwest) & Long Beach City PUMA,21181,13400,7781,114095.38218214437,127125.06119402985,91656.4027759928,13931,8351,5580,136396.396525734,155833.7324871273,107306.5770609319,7130,4929,2201,71554.57082748949,80295.45952525867,51979.904588823265,120,120,0,52766.666666666664,52766.666666666664,0.0
136,NYC-Brooklyn Community District 13--Brighton Beach & Coney Island PUMA,4710,1769,2941,87511.31634819532,116285.24590163934,70203.91023461407,3245,905,2340,112049.49152542373,189016.13259668509,82282.47863247863,1326,806,520,33900.452488687784,41053.101736972705,22813.846153846152,139,58,81,26084.172661870503,26900.0,25500.0
137,NYC-Manhattan Community District 8--Upper East Side PUMA,63089,29910,33179,156617.37006451204,173813.1547977265,141115.82024774706,57766,25044,32722,160095.78921857147,183094.9672576266,142493.2155736202,4460,4003,457,74675.15695067265,78349.33799650263,42491.90371991247,863,863,0,347263.8470451912,347263.8470451912,0.0
138,NYC-Brooklyn Community District 7--Sunset Park & Windsor Terrace PUMA,11301,6533,4768,113024.60844173082,128677.63661411297,91577.20218120805,9434,5345,4089,123635.16005935977,145924.4153414406,94499.41305942774,1831,1152,679,60264.66411796832,52181.07638888889,73979.38144329897,36,36,0,15900.0,15900.0,0.0
139,"NYC-Bronx Community District 7--Bedford Park, Fordham North & Norwood PUMA",535,351,184,75714.95327102803,72393.16239316239,82051.63043478261,79,0,79,88500.0,0.0,88500.0,456,351,105,73500.0,72393.16239316239,77200.0,0,0,0,#DIV/0!,0.0,0.0
140,Monroe County (East) PUMA,41756,22293,19463,64280.34078934764,70885.17112995111,56715.14103683913,21636,11113,10523,77287.27999630246,84399.97750382435,69775.79017390478,19885,11072,8813,50608.96756349007,57875.19598988439,41480.21672529218,235,108,127,23587.23404255319,14000.0,31740.15748031496
141,Suffolk County (East) PUMA,34138,18256,15882,89139.88692952135,99584.78582383874,77133.71174914998,15725,7314,8411,121828.14499205087,152053.9745693191,95544.50243728451,17968,10497,7471,61391.91228851291,64940.18100409641,56406.478383081245,445,445,0,54426.96629213483,54426.96629213483,0.0
142,"NYC-Queens Community District 8--Briarwood, Fresh Meadows & Hillcrest PUMA",8354,4964,3390,76597.66219774958,83817.98952457696,66024.88790560472,5112,2697,2415,91412.37676056338,98333.96366332963,83682.55486542443,3242,2267,975,53237.75447254781,66548.65460961623,22288.20512820513,0,0,0,#DIV/0!,0.0,0.0
143,"NYC-Bronx Community District 9--Castle Hill, Clason Point & Parkchester PUMA",682,297,385,83095.30791788857,81774.41077441078,84114.28571428571,430,223,207,104909.30232558139,89000.0,122048.30917874396,252,74,178,45873.01587301587,60000.0,40000.0,0,0,0,#DIV/0!,0.0,0.0
144,Suffolk County (Central)--Islip Town (Northwest) PUMA,6946,3126,3820,67895.64065649295,84364.36340371081,54418.879581151836,2184,928,1256,77878.32417582418,86678.87931034483,71376.00318471338,4474,2150,2324,64978.958426464014,84735.3488372093,46701.74698795181,288,48,240,37503.47222222222,23000.0,40404.166666666664
145,NYC-Manhattan Community District 7--Upper West Side & West Side PUMA,54060,26326,27734,207141.3512763596,260678.83803084402,156321.85620537968,51365,24650,26715,209308.53596807164,264655.11521298176,158240.10331274566,2695,1676,1019,165836.17810760668,202197.1957040573,106031.40333660452,0,0,0,#DIV/0!,0.0,0.0
146,Capital Region,325324,175897,149427,526537.9184342016,580255.5321347401,461597.6012087255,136890,68866,68024,693815.0468913269,810830.1374112687,576210.2312321445,176991,97842,79149,415516.76906197396,448895.4854391829,374920.17097491265,11443,9189,2254,311160.69403536525,335723.13815612055,241558.73454788755
147,Central NY,226313,124379,101934,371900.0072405024,417411.48204245436,317133.6962987289,89863,43686,46177,492809.3679110905,576070.3548594697,412242.5303468539,126165,73572,52593,293341.8895541978,326479.46166575624,246872.6962584282,10285,7121,3164,266293.71486575075,311422.3468946459,198359.56990810388
148,Finger Lakes,337723,184791,152932,583846.097527381,648026.7267654442,506463.86835883406,138540,68079,70461,730254.3259533319,825932.2256697003,637323.2837967278,186752,106995,79757,480204.86215942475,536811.3342474104,399212.4045738956,12431,9717,2714,365217.7452781187,371034.1750792394,289344.90996265574
149,Long Island,600427,346180,254247,2491601.4123930424,2899535.9792250446,1922488.693966423,318969,171303,147666,2993501.134335587,3576271.058072941,2286454.7704077135,272779,168579,104200,1811692.3572511156,2117291.536376936,1320364.4104791945,8679,6298,2381,1748384.7519892333,1566418.242481287,848189.6981837606
150,Mid-Hudson,454239,255525,198714,1758422.4604369877,2078084.1530562516,1339685.2317285442,252152,127337,124815,2130377.3670585128,2660220.630703537,1566404.841913679,191815,119840,71975,1132713.416441533,1249827.1089772256,936718.2009776758,10272,8348,1924,#DIV/0!,679035.4051811434,407862.31888727145
151,Mohawk Valley,138610,77036,61574,209599.69496119558,236087.2015525941,176388.55935815463,42183,19961,22222,292895.9379108263,368352.6169030559,222631.93276187027,89599,52469,37130,174561.69990394686,189693.19360000076,153155.12948439489,6828,4606,2222,155600.30738758564,176163.20016832268,110708.56078176023
152,New York City,840429,459212,381217,5108870.201452344,5644579.074615393,4417614.903845295,641522,327083,314439,5579607.952144863,6177302.315883866,4743632.470668915,185252,120839,64413,#DIV/0!,4065297.1602412583,2978653.21361828,13655,11290,2365,#DIV/0!,2855560.283329678,1271119.4211485584
153,North Country,117937,66812,51125,151564.52037411893,164172.7129751385,134628.95702706435,32928,14225,18703,199063.84695145383,241696.34983783128,165034.07505029085,79806,48356,31450,134667.91895427648,146018.76317714463,116722.43303061405,5203,4231,972,89881.01090632792,85882.1922198915,95329.46382205808
154,Southern Tier,167997,92237,75760,333116.70464250963,371779.08868176676,286566.83838349936,56655,28044,28611,423159.80400939565,485394.94456808385,361969.2988503005,104163,59458,44705,289259.205163847,327163.37904813443,236948.01469997127,7179,4735,2444,257103.2287616805,253571.99271209034,193070.74316803267
155,Western NY,389707,215917,173790,649777.5277197271,712587.3494051113,572494.0179341753,157005,78596,78409,822491.9978650212,937958.2148277457,713340.0030513891,222400,130577,91823,528279.1432432582,579413.2014051088,457355.23156153143,10302,6744,3558,416644.0223394982,449122.77378509234,355901.7655883564
