,puma,Total_geo,Total_geo_m,Total_geo_f,Total_Avg_PINCP_mf_t,Total_Avg_PINCP_m,Total_Avg_PINCP_f,Total_BABS,Total_BABS_m,Total_BABS_f,BABS_Avg_PINCP_mf_t,BABS_Avg_PINCP_m,BABS_Avg_PINCP_f,Total_HS,Total_HS_m,Total_HS_f,HS_Avg_PINCP_mf_t,HS_Avg_PINCP_m,HS_Avg_PINCP_f,Total_HSINC,Total_HSINC_m,Total_HSINC_f,HSINC_Avg_PINCP_mf_t,HSINC_Avg_PINCP_m,HSINC_Avg_PINCP_f
0,Total Geo,497658,264033,233625,53035.3371672916,56492.155957778006,49128.588164794004,156380,68173,88207,75864.9100140683,87939.62652369706,66532.66145544004,287011,159521,127490,44848.509611129884,48774.13666539202,39936.59531727979,54267,36339,17928,30546.91809018372,31376.377996092353,28865.651717983044
1,Westchester County (Southwest)--Yonkers City PUMA,10392,5578,4814,57060.54080061586,60146.27106489781,53485.09347735771,3903,1674,2229,70879.65667435306,69969.89247311828,71562.89816061014,5386,3364,2022,51771.84181210546,57773.900118906065,41786.2215628091,1103,540,563,33986.128739800544,44472.03703703704,23928.59680284192
2,St. Lawrence County PUMA,237,137,100,33208.649789029536,25578.467153284673,43662.0,82,19,63,49122.560975609755,53318.42105263158,47857.142857142855,83,46,37,32053.01204819277,28460.869565217392,36518.91891891892,72,72,0,16416.666666666668,16416.666666666668,0.0
3,"NYC-Queens Community District 7--Flushing, Murray Hill & Whitestone PUMA",4249,2155,2094,48199.039774064484,49897.73549883991,46450.859598853865,1248,670,578,66491.92307692308,64702.71641791045,68565.9169550173,2636,1284,1352,43038.35356600911,45103.34890965732,41077.218934911245,365,201,164,22922.465753424658,31174.626865671642,12808.536585365853
4,Erie County (Central) PUMA,1092,583,509,39018.60805860806,37273.92795883362,41016.9351669941,260,109,151,52165.846153846156,52084.40366972477,52224.6357615894,700,383,317,36501.42857142857,36003.39425587467,37103.154574132495,132,91,41,26471.21212121212,24881.31868131868,30000.0
5,Monroe County (South) PUMA,1221,716,505,61485.12694512695,64856.28491620112,56705.425742574254,754,489,265,76401.64456233422,77390.79754601227,74576.37735849057,410,202,208,40830.48780487805,41797.0297029703,39891.82692307692,57,25,32,12736.842105263158,6000.0,18000.0
6,Onondaga County (North) PUMA,686,505,181,54980.0,62772.83168316832,33237.56906077348,315,235,80,79377.77777777778,90293.6170212766,47312.5,337,236,101,34899.109792284864,40381.35593220339,22089.10891089109,34,34,0,27978.823529411766,27978.823529411766,0.0
7,"NYC-Bronx Community District 9--Castle Hill, Clason Point & Parkchester PUMA",17290,7976,9314,41533.34274146906,42467.60406218656,40733.29246295898,3350,910,2440,58899.7271641791,66194.74725274726,56179.04344262295,11455,5611,5844,39820.77782627673,42312.18855818927,37428.699520876115,2485,1455,1030,26016.25754527163,28227.285223367697,22892.912621359224
8,"Clinton, Franklin, Essex & Hamilton Counties PUMA",593,412,181,44440.843170320404,42540.82524271845,48765.74585635359,149,93,56,67793.28859060403,60873.11827956989,79285.71428571429,324,199,125,44289.1975308642,50065.82914572865,35092.8,120,120,0,15854.333333333334,15854.333333333334,0.0
9,Suffolk County (Southwest)--Babylon Town (Southeast) PUMA,2907,1659,1248,60813.88785689714,60329.23447860157,61458.15064102564,1032,359,673,79031.68604651163,73738.16155988858,81855.42347696879,1697,1147,550,51805.81732469063,58350.82824760244,38156.494545454545,178,153,25,41071.910112359554,43698.03921568627,25000.0
10,Suffolk County (Northwest)--Smithtown Town PUMA,1464,798,666,64328.1174863388,58293.796992481206,71558.42942942942,707,286,421,73708.01131541726,50494.93006993007,89477.46793349169,729,512,217,56933.88203017833,62650.1953125,43446.543778801846,28,0,28,20000.0,0.0,20000.0
11,"NYC-Bronx Community District 12--Wakefield, Williamsbridge & Woodlawn PUMA",4896,2069,2827,44606.319444444445,46107.80570323828,43507.42483197736,1383,284,1099,55282.27765726681,52137.67605633803,56094.89535941765,3222,1616,1606,40576.6139044072,45494.70915841584,35627.89539227895,291,169,122,38485.56701030928,41837.27810650888,33842.62295081967
12,Dutchess County (Southwest) PUMA,4215,2175,2040,54383.81115065243,63788.89195402299,44356.33529411765,1272,647,625,77761.2106918239,98791.12828438949,55991.04,2517,1279,1238,46268.065156932855,52679.734167318216,39644.0549273021,426,249,177,32532.356807511736,29902.008032128513,36232.67796610169
13,Ulster County (East) PUMA,2116,1230,886,50441.73440453686,55133.35772357724,43928.532731376974,447,186,261,66325.05592841163,76610.21505376344,58995.402298850575,1521,896,625,47882.36686390533,55029.24107142857,37636.608,148,148,0,28772.5,28772.5,0.0
14,Orange County (Northwest) PUMA,4898,2639,2259,55015.12923642303,58270.9435392194,51211.63479415671,1528,610,918,72978.0104712042,83682.7868852459,65864.81481481482,2701,1511,1190,51846.35431321733,58605.10919920582,43264.43949579832,669,518,151,26781.3153961136,27371.04247104247,24758.278145695363
15,"NYC-Bronx Community District 11--Pelham Parkway, Morris Park & Laconia PUMA",11605,5990,5615,46657.627746660924,47698.17028380634,45547.592163846835,2777,856,1921,61999.60388908895,74003.85514018692,56650.494534096826,7312,3823,3489,43536.64797592998,46337.75568924928,40467.39180280883,1516,1311,205,33607.45382585752,34489.32112890923,27967.80487804878
16,"NYC-Manhattan Community District 1 & 2--Battery Park City, Greenwich Village & Soho PUMA",3442,2161,1281,135564.22719349214,151273.7621471541,109062.8181108509,2400,1534,866,158932.02916666667,174163.36375488917,131951.81293302542,918,520,398,71167.97385620915,79986.53846153847,59646.23115577889,124,107,17,160024.1935483871,169560.7476635514,100000.0
17,"NYC-Brooklyn Community District 12--Borough Park, Kensington & Ocean Parkway PUMA",2085,1109,976,43403.10791366907,45229.57619477007,41327.74590163935,601,284,317,59083.19467554076,63534.50704225352,55095.268138801264,1376,783,593,37465.24709302326,39473.81864623244,34813.1197301855,108,42,66,31799.074074074073,28757.14285714286,33734.84848484849
18,"NYC-Staten Island Community District 1--Port Richmond, Stapleton & Mariner's Harbor PUMA",8516,4378,4138,53679.59006575857,56892.95568752855,50279.8523441276,2137,864,1273,71965.87505849321,79180.97222222222,67068.90416339356,5525,2977,2548,49911.32018099548,54491.501511588845,44559.98587127159,854,537,317,32300.081967213115,34345.99627560521,28834.29022082019
19,Monroe County (Central)--Greece & Gates Towns PUMA,1726,1061,665,42519.640787949014,42252.87464655985,42945.26315789474,306,105,201,56642.1568627451,81805.71428571429,43497.014925373136,1289,841,448,40870.13188518231,39364.922711058265,43695.75892857143,131,115,16,25761.8320610687,27259.130434782608,15000.0
20,Westchester County (South Central)--New Rochelle & Mount Vernon Cities PUMA,4680,2359,2321,69229.31196581197,74396.5663416702,63977.45799224472,2214,991,1223,91593.45076784102,99812.81533804238,84933.27882256746,2291,1193,1098,50421.33566128328,59427.49371332774,40635.956284153006,175,175,0,32514.285714285714,32514.285714285714,0.0
21,Orange County (Northeast)--Greater Newburgh City PUMA,5420,2855,2565,53357.052583025834,56279.29071803853,50104.42495126706,1364,623,741,71578.79032258065,68922.95345104334,73811.7004048583,3693,2004,1689,49824.73734091524,56417.85179640719,42002.00118413262,363,228,135,20823.691460055095,20513.157894736843,21348.14814814815
22,Suffolk County (East) PUMA,1642,1171,471,49495.779537149814,55924.86763450043,33511.78343949045,564,358,206,77007.35815602836,99245.81005586592,38359.95145631068,926,661,265,35827.753779697625,38267.17095310136,29743.01886792453,152,152,0,30680.394736842107,30680.394736842107,0.0
23,Tompkins County PUMA,807,387,420,36078.51301115242,30001.188630490957,41678.333333333336,374,194,180,42050.802139037434,34814.43298969072,49850.0,378,190,188,31605.449735449736,25362.947368421053,37914.36170212766,55,3,52,26209.090909090908,12500.0,27000.0
24,Monroe County (Central)--Rochester City (East) PUMA,4474,2262,2212,29335.007152436297,33187.480990274096,25395.452079566003,468,151,317,40738.46581196581,42310.41059602649,39989.68454258675,2927,1367,1560,28071.09668602665,32897.61521580102,23841.70512820513,1079,744,335,27817.534754402226,31868.50806451613,18820.746268656716
25,Ontario & Yates Counties PUMA,1216,740,476,33997.68996710526,37087.501351351355,29194.201680672268,327,227,100,48664.83180428135,47888.10572687224,50428.0,695,377,318,30791.58417266187,35589.259946949605,25103.77358490566,194,136,58,20761.03092783505,23213.235294117647,15011.034482758621
26,"NYC-Bronx Community District 7--Bedford Park, Fordham North & Norwood PUMA",10215,5954,4261,41017.900146842876,38219.18542156534,44928.61300164281,2049,756,1293,63415.37335285505,61865.079365079364,64321.80974477958,6330,3825,2505,36063.515007898895,37913.132026143794,33239.249500998005,1836,1373,463,33103.32244008715,26051.930080116534,54013.822894168465
27,Chautauqua County PUMA,1904,1100,804,26674.758403361346,26348.78181818182,27120.746268656716,229,98,131,38927.510917030566,30755.102040816328,45041.2213740458,1253,753,500,28737.62170790104,30482.523240371847,26109.8,422,249,173,13900.710900473934,12113.734939759037,16472.71676300578
28,Genesee & Orleans Counties PUMA,559,385,174,30127.549194991054,27213.766233766233,36574.71264367816,54,29,25,40109.25925925926,34100.0,47080.0,364,215,149,30391.20879120879,27327.441860465115,34812.08053691275,141,141,0,25624.113475177306,25624.113475177306,0.0
29,"NYC-Brooklyn Community District 15--Sheepshead Bay, Gerritsen Beach & Homecrest PUMA",2267,1150,1117,51837.93559770622,55200.86956521739,48375.6490599821,784,345,439,75673.4693877551,93117.10144927536,61964.92027334852,1067,502,565,39588.940955951264,40975.298804780876,38357.16814159292,416,303,113,38334.61538461538,35597.359735973594,45674.33628318584
30,Broome County (West Central)--Greater Binghamton City & Greater Johnson City Village PUMA,919,415,504,34210.663764961915,38260.24096385542,30876.190476190477,220,98,122,46124.09090909091,48377.551020408166,44313.934426229505,657,301,356,30959.360730593606,36425.91362126246,26337.3595505618,42,16,26,22666.666666666668,10800.0,29969.23076923077
31,Westchester County (Central)--White Plains City PUMA,4567,2657,1910,63815.75257280491,66344.4644335717,60298.062827225134,1986,960,1026,74129.34541792548,79056.33333333333,69519.29824561403,2398,1594,804,57815.49207673061,61821.73776662484,49872.76119402985,183,103,80,30514.273224043714,17857.398058252427,46810.0
32,Nassau County (Northwest)--North Hempstead Town (North) PUMA,1160,770,390,98611.56896551725,103586.0,88790.2564102564,551,316,235,156037.277676951,183891.58227848102,118582.12765957447,501,382,119,50073.612774451096,50087.64397905759,50028.57142857143,108,72,36,30796.296296296296,34972.22222222222,22444.444444444445
33,Cattaraugus & Allegany Counties PUMA,274,180,94,31719.671532846714,31327.055555555555,32471.489361702126,60,18,42,35476.666666666664,49500.0,29466.666666666668,188,136,52,32343.563829787236,31366.691176470587,34898.46153846154,26,26,0,18538.46153846154,18538.46153846154,0.0
34,NYC-Brooklyn Community District 1--Greenpoint & Williamsburg PUMA,7187,3794,3393,56802.65618477807,64243.08118081181,48482.88829944003,3046,1274,1772,76342.79382797111,101457.41758241758,58286.34311512415,3569,2162,1407,44269.106192210704,47566.46623496762,39202.373845060414,572,358,214,30951.223776223775,32521.787709497206,28323.831775700935
35,Suffolk County (Northwest)--Huntington Town (North) PUMA,1704,1061,643,79980.86854460093,89516.68237511782,64246.03421461897,611,365,246,114979.05073649755,129423.01369863014,93547.9674796748,943,587,356,61027.99575821845,71758.09199318569,43335.393258426964,150,109,41,56572.0,51521.10091743119,70000.0
36,"NYC-Manhattan Community District 9--Hamilton Heights, Manhattanville & West Harlem PUMA",4572,2145,2427,43612.6968503937,41711.74731934732,45292.76967449526,1617,553,1064,55690.94124922696,50632.007233273056,58320.25563909775,2385,1258,1127,39154.548427672955,43347.21621621621,34474.53416149069,570,334,236,28002.456140350878,20782.63473053892,38220.338983050846
37,NYC-Brooklyn Community District 10--Bay Ridge & Dyker Heights PUMA,4319,2304,2015,57919.914332021304,57293.953993055555,58635.65260545906,1725,703,1022,69795.6463768116,70262.94452347084,69474.20743639921,2308,1343,965,53462.6603119584,57429.35219657483,47942.17616580311,286,258,28,22261.53846153846,21251.162790697676,31571.428571428572
38,"NYC-Brooklyn Community District 6--Park Slope, Carroll Gardens & Red Hook PUMA",3746,2103,1643,76519.88521089162,82140.13314312886,69326.10468654899,1876,901,975,98452.34008528784,118111.20976692563,80285.52820512821,1556,928,628,57148.393316195376,58838.900862068964,54650.31847133758,314,274,40,41477.70700636943,42773.722627737225,32600.0
39,Livingston & Wyoming Counties PUMA,444,353,91,37286.48648648649,42835.6940509915,15760.439560439561,67,58,9,58401.49253731343,60636.206896551725,44000.0,233,207,26,46052.789699570814,47985.02415458937,30669.23076923077,144,88,56,13277.777777777777,18990.909090909092,4300.0
40,Albany County (Outside Albany City) PUMA,1758,825,933,58918.29124004551,74509.81818181818,45131.57127545552,874,353,521,79621.2814645309,111250.42492917847,58191.170825335896,792,397,395,38269.893939393936,50074.55919395466,26405.458227848103,92,75,17,39995.65217391304,30928.0,80000.0
41,NYC-Manhattan Community District 3--Chinatown & Lower East Side PUMA,8051,4215,3836,46459.93690224817,47397.48327402135,45429.76016684046,2762,1208,1554,68332.30123099203,74990.07947019867,63156.88545688546,4403,2504,1899,36153.44901203725,38897.218849840254,32535.545023696683,886,503,383,29493.792325056434,23446.79920477137,37435.4046997389
42,Nassau County (Northeast)--Oyster Bay Town (North) & Glen Cove City PUMA,1121,733,388,83592.47992863515,95377.03956343792,61329.38144329897,275,159,116,156554.8,219305.4716981132,70543.10344827586,781,519,262,62194.87836107554,63998.84393063584,58621.37404580152,65,55,10,32006.153846153848,33207.27272727273,25400.0
43,"NYC-Queens Community District 11--Bayside, Douglaston & Little Neck PUMA",2318,1302,1016,75833.5823986195,81666.85407066053,68358.26771653544,1235,609,626,90505.75222672065,103822.00985221675,77551.11821086262,1041,672,369,54271.12391930836,54059.880952380954,54655.82655826558,42,21,21,178842.85714285713,322590.4761904762,35095.23809523809
44,Erie County (South) PUMA,800,429,371,51670.78,58620.18648018648,43634.943396226416,360,219,141,65933.88888888889,70802.28310502283,58372.34042553192,372,142,230,45416.83870967742,62936.619718309856,34600.27826086956,68,68,0,10372.941176470587,10372.941176470587,0.0
45,NYC-Manhattan Community District 7--Upper West Side & West Side PUMA,4846,2741,2105,83347.02765167148,96118.20357533747,66717.1971496437,2893,1736,1157,105081.98963014172,129851.84101382489,67916.50821089023,1663,832,831,56485.44798556825,41893.028846153844,71095.42719614922,290,173,117,20559.310344827587,18394.219653179192,23760.68376068376
46,"NYC-Queens Community District 12--Jamaica, Hollis & St. Albans PUMA",4256,2203,2053,41625.71428571428,41010.916931457105,42285.431076473455,1016,391,625,52742.71653543307,50912.659846547314,53887.6,2749,1449,1300,39895.46744270644,41373.98205659075,38247.49230769231,491,363,128,28309.164969450103,28896.143250688707,26644.53125
47,NYC-Brooklyn Community District 3--Bedford-Stuyvesant PUMA,3891,1883,2008,48556.430223592906,46220.85501858736,50746.613545816734,1336,678,658,73151.34730538922,58886.135693215336,87850.1519756839,2069,895,1174,37559.49250845819,42856.74860335195,33521.124361158436,486,310,176,27761.893004115227,28233.16129032258,26931.81818181818
48,Dutchess County (North & East) PUMA,1640,1118,522,61046.11768292683,60013.03488372093,63258.73563218391,475,294,181,91153.17894736842,102324.14965986395,73008.06629834254,1009,691,318,50259.14073339941,45651.046309696096,60272.32704402516,156,133,23,39143.58974358974,41100.75187969925,27826.08695652174
49,Oneida County (Central)--Greater Utica & Rome Cities PUMA,1310,633,677,37012.70229007633,35123.61769352291,38779.01033973412,292,59,233,61593.49315068493,61566.101694915254,61600.42918454936,860,502,358,32305.39534883721,34975.3984063745,28561.424581005587,158,72,86,17206.962025316454,14488.888888888889,19482.558139534885
50,NYC-Brooklyn Community District 7--Sunset Park & Windsor Terrace PUMA,6191,3412,2779,49483.01243740914,46253.50527549824,53448.136020151134,2033,837,1196,70311.4215445155,58954.83870967742,78259.13043478261,3193,1942,1251,41503.360476041344,45415.9938208033,35429.552358113506,965,633,332,32006.19689119171,32028.27804107425,31964.09638554217
51,"NYC-Bronx Community District 1 & 2--Hunts Point, Longwood & Melrose PUMA",10412,4798,5614,37892.56588551671,41189.62401000417,35074.738154613464,1630,556,1074,45837.1963190184,47309.352517985615,45075.07448789572,6758,3122,3636,36062.022787807044,38106.758488148625,34306.33938393839,2024,1120,904,37606.529644268776,46745.10357142857,26284.402654867255
52,Warren & Washington Counties PUMA,331,216,115,40958.91238670695,37499.53703703704,47456.52173913043,47,0,47,63510.63829787234,0.0,63510.63829787234,215,147,68,38444.186046511626,39408.163265306124,36360.294117647056,69,69,0,33433.333333333336,33433.333333333336,0.0
53,Oswego County PUMA,399,194,205,42219.29824561404,50389.17525773196,34487.80487804878,88,16,72,52781.818181818184,85250.0,45566.666666666664,290,157,133,41011.03448275862,51617.83439490446,28490.225563909775,21,21,0,14642.857142857143,14642.857142857143,0.0
54,Erie County (Northeast) PUMA,497,363,134,47903.42052313883,49517.906336088156,43529.850746268654,127,38,89,61236.220472440946,99789.47368421052,44775.2808988764,174,140,34,51482.75862068965,54085.71428571428,40764.705882352944,196,185,11,36086.73469387755,35735.13513513513,42000.0
55,Herkimer (North & Central) & Oneida (Outer) Counties PUMA,258,168,90,34088.37209302326,31796.428571428572,38366.666666666664,63,62,1,28158.73015873016,28161.290322580644,28000.0,162,85,77,32967.9012345679,33832.94117647059,32012.987012987014,33,21,12,50909.09090909091,34285.71428571428,80000.0
56,Saratoga County (South & Central) PUMA,902,554,348,61851.35254988913,66488.5559566787,54469.137931034486,342,258,84,67904.26900584795,72523.25581395348,53717.380952380954,473,249,224,63255.09513742072,67878.15261044177,58116.07142857143,87,47,40,30425.287356321838,26000.0,35625.0
57,Columbia & Greene Counties PUMA,862,408,454,36492.41299303944,30049.70588235294,42282.33480176212,155,85,70,42145.8064516129,32882.35294117647,53394.28571428572,557,205,352,39072.45960502693,33564.78048780488,42280.056818181816,150,118,32,21070.0,21902.542372881355,18000.0
58,"NYC-Queens Community District 8--Briarwood, Fresh Meadows & Hillcrest PUMA",4075,2417,1658,52065.78404907975,53150.91849400083,50483.89626055489,1288,592,696,62984.24689440994,68243.7668918919,58510.63218390805,2467,1633,834,48879.35143899473,49644.00489895897,47382.13429256595,320,192,128,32684.375,36441.666666666664,27048.4375
59,NYC-Queens Community District 6--Forest Hills & Rego Park PUMA,3753,1891,1862,70159.99680255796,74833.64357482814,65413.55961331901,2077,801,1276,85073.63986519018,107882.08489388265,70755.79937304075,1602,1028,574,53427.35205992509,52718.84241245136,54696.25087108014,74,62,12,13809.45945945946,14546.774193548386,10000.0
60,NYC-Queens Community District 10--Howard Beach & Ozone Park PUMA,6721,3432,3289,52274.92277934831,58542.09498834499,45735.264822134384,1742,722,1020,68078.76004592422,91075.34626038781,51800.78431372549,4413,2422,1991,49041.93201903467,52395.52436003303,44962.37368156705,566,288,278,28841.890459363956,28673.993055555555,29015.827338129497
61,Erie County (North Central) PUMA,612,300,312,55826.78104575163,52387.666666666664,59133.6217948718,315,190,125,64608.22222222222,58775.26315789474,73474.32,292,105,187,47086.98630136986,42704.76190476191,49547.5935828877,5,5,0,13000.0,13000.0,0.0
62,NYC-Brooklyn Community District 16--Brownsville & Ocean Hill PUMA,2697,1064,1633,37840.352243233225,41647.34962406015,35359.859154929574,573,122,451,52982.19895287958,81409.83606557376,45292.23946784923,1678,771,907,29015.685339690106,27234.215304798963,30530.03307607497,446,171,275,51588.139013452914,78264.32748538011,35000.4
63,NYC-Staten Island Community District 2--New Springville & South Beach PUMA,4121,2000,2121,65141.36132006795,87471.48,44085.143800094294,751,230,521,134197.5499334221,281731.1304347826,69067.56238003839,3145,1555,1590,48760.1240063593,61723.60128617363,36082.00628930818,225,215,10,63620.444444444445,65881.86046511628,15000.0
64,Madison & Cortland Counties PUMA,639,416,223,33572.190923317685,29541.346153846152,41091.61434977579,167,70,97,54045.209580838324,55117.142857142855,53271.64948453608,423,320,103,27181.513002364067,24513.75,35469.70873786408,49,26,23,18965.30612244898,22561.53846153846,14900.0
65,Westchester County (Northwest) PUMA,3787,1725,2062,69262.48376023237,77695.20579710144,62207.95150339476,1444,401,1043,105522.46814404432,133260.42394014963,94858.11505273251,2099,1122,977,49964.64125774178,68276.64884135472,28934.884339815762,244,202,42,20683.60655737705,19704.950495049507,25390.47619047619
66,NYC-Brooklyn Community District 4--Bushwick PUMA,9324,4714,4610,41400.12977262977,42586.09461179465,40187.409978308024,2302,746,1556,49944.613379669856,54656.970509383376,47685.3470437018,5266,2861,2405,41967.2825674136,45008.89549108703,38348.96465696466,1756,1107,649,28498.063781321183,28189.972899728997,29023.57473035439
67,"Rockland County (South)--Orangetown, Clarkstown (South) & Ramapo (Southeast) Towns PUMA",2441,1189,1252,68078.9434657927,82445.56433978133,54435.24361022364,1221,595,626,75042.11384111384,93483.48907563025,57513.9696485623,1183,563,620,61006.99915469146,72676.90941385436,50409.967741935485,37,31,6,64405.40540540541,48000.0,149166.66666666666
68,"NYC-Manhattan Community District 12--Washington Heights, Inwood & Marble Hill PUMA",13545,7923,5622,43622.26651901071,46546.6010349615,39501.04589114194,5725,2598,3127,53166.52925764192,62394.18783679754,45499.92964502718,6206,4007,2199,40611.7338059942,45122.81507362116,32391.678035470668,1614,1318,296,21343.742255266417,19636.949924127464,28943.58108108108
69,NYC-Brooklyn Community District 2--Brooklyn Heights & Fort Greene PUMA,3944,2217,1727,65042.619168357,72776.30130807398,55114.66705269253,1762,930,832,84583.68898978434,98632.47311827957,68880.12019230769,1778,951,827,55410.028121484815,65930.45215562565,43312.176541717046,404,336,68,22209.40594059406,20586.309523809523,30229.41176470588
70,"NYC-Queens Community District 14--Far Rockaway, Breezy Point & Broad Channel PUMA",3906,2146,1760,51979.4674859191,46005.312208760486,59263.86363636364,719,325,394,75908.20584144646,80072.61538461539,72473.09644670051,2899,1641,1258,48547.533632287,42525.411334552104,56403.10015898251,288,180,108,26786.458333333332,16220.0,44397.22222222222
71,Suffolk County (Central)--Islip Town (East) PUMA,1923,959,964,70914.12896515861,77893.45151199166,63971.00622406639,857,333,524,93253.64060676779,110242.4024024024,82457.34732824427,1001,561,440,53416.08391608392,62404.8128342246,41955.454545454544,65,65,0,45846.153846153844,45846.153846153844,0.0
72,NYC-Brooklyn Community District 14--Flatbush & Midwood PUMA,2556,1316,1240,48665.2034428795,45003.54103343465,52551.290322580644,1003,395,608,70000.05982053839,60476.86075949367,76187.00657894737,1053,474,579,36174.83380816714,44536.70886075949,29329.360967184803,500,447,53,32172.2,31825.279642058165,35098.11320754717
73,"NYC-Bronx Community District 4--Concourse, Highbridge & Mount Eden PUMA",7302,3233,4069,35147.040810736784,37148.09464893288,33557.11526173507,1672,691,981,46186.66985645933,42254.25470332851,48956.59734964322,4333,1848,2485,34558.70759289176,39314.93506493507,31021.682092555333,1297,694,603,22881.033153430995,26294.092219020175,18952.90215588723
74,Erie County (West Central)--Buffalo City (East) PUMA,1392,672,720,29312.6558908046,27958.854166666668,30576.204166666666,183,41,142,35602.00546448088,18468.29268292683,40549.06338028169,913,430,483,32348.411829134722,32830.6976744186,31919.04761904762,296,201,95,16060.641891891892,19472.388059701494,8842.105263157895
75,Nassau County (East Central)--Oyster Bay Town (Central) PUMA,1964,1259,705,69631.23727087576,72819.81731532962,63937.02127659575,613,290,323,91356.03588907015,103418.10344827586,80526.31578947368,1146,860,286,64832.547993019194,66456.3953488372,59949.65034965035,205,109,96,31494.634146341465,41618.34862385321,20000.0
76,Niagara County (Southwest)--Greater Niagara Falls & North Tonawanda Area PUMA,561,390,171,44457.2192513369,46043.333333333336,40839.76608187135,51,34,17,106033.33333333333,146550.0,25000.0,491,337,154,38814.2566191446,37089.61424332344,42588.31168831169,19,19,0,25000.0,25000.0,0.0
77,"NYC-Manhattan Community District 6--Murray Hill, Gramercy & Stuyvesant Town PUMA",3325,1880,1445,85711.58496240602,86702.72340425532,84422.07612456748,2460,1290,1170,100391.11788617886,107548.25581395348,92499.91452991453,847,590,257,44239.51593860685,41125.20338983051,51389.105058365756,18,0,18,31000.0,0.0,31000.0
78,Jefferson & Lewis Counties PUMA,1518,1207,311,32341.100131752304,30478.21043910522,39571.028938906755,223,69,154,42330.4932735426,39717.391304347824,43501.2987012987,1191,1073,118,30653.2241813602,29767.474370922646,38707.542372881355,104,65,39,30250.96153846154,32403.076923076922,26664.102564102563
79,Fulton & Montgomery Counties PUMA,1711,922,789,31185.006428988894,34170.62472885032,27696.108998732572,113,13,100,44000.14159292035,58478.153846153844,42118.0,1182,624,558,32622.36040609137,36752.243589743586,28003.99641577061,416,285,131,23619.951923076922,27409.473684210527,15375.57251908397
80,"NYC-Bronx Community District 8--Riverdale, Fieldston & Kingsbridge PUMA",8130,4210,3920,53222.93234932349,53172.19002375297,53277.42857142857,3280,1379,1901,61878.65243902439,63348.049311095,60812.74066280905,4163,2358,1805,47521.619024741776,48298.72773536896,46506.42659279778,687,473,214,46445.356622998544,47800.33826638478,43450.46728971963
81,NYC-Brooklyn Community District 8--Crown Heights North & Prospect Heights PUMA,2709,1449,1260,55900.52417866371,50802.98136645963,61762.69841269841,1334,715,619,71544.75262368815,65708.39160839161,78286.26817447496,1220,661,559,41536.70491803279,37220.0,46641.07334525939,155,73,82,34316.3870967742,27802.739726027397,40115.12195121951
82,NYC-Queens Community District 3--Jackson Heights & North Corona PUMA,7046,4358,2688,45232.20550667045,46029.87150068839,43938.96577380953,1936,1042,894,63015.0,69039.96161228407,55992.61744966443,4331,2636,1695,40710.91664742554,42215.075872534144,38371.70501474926,779,680,99,26174.711168164315,25558.235294117647,30409.090909090908
83,Monroe County (North & West) PUMA,957,601,356,56854.545454545456,67056.23960066556,39632.02247191011,412,235,177,84424.5145631068,98774.0425531915,65372.8813559322,545,366,179,36012.66055045871,46690.983606557376,14178.77094972067,0,0,0,#DIV/0!,0.0,0.0
84,NYC-Brooklyn Community District 5--East New York & Starrett City PUMA,6407,3347,3060,41357.24832214765,43950.22109351658,38521.07843137255,1082,431,651,57283.73382624769,58849.88399071926,56246.8509984639,4358,2343,2015,39497.66865534649,43095.20273154076,35314.53101736973,967,573,394,31917.321613236814,36239.14485165794,25632.030456852794
85,"Steuben (North & West), Schuyler & Chemung (North) Counties PUMA",263,101,162,37685.91254752852,35627.623762376235,38969.166666666664,85,28,57,40044.17647058824,32969.642857142855,43519.38596491228,172,67,105,36788.604651162794,37242.388059701494,36499.04761904762,6,6,0,30000.0,30000.0,0.0
86,NYC-Brooklyn Community District 13--Brighton Beach & Coney Island PUMA,2227,1132,1095,43131.347103726985,39018.37455830388,47383.29680365297,340,106,234,42294.705882352944,52339.622641509435,37744.444444444445,1233,503,730,38932.72506082725,46260.03976143141,33883.90410958904,654,523,131,51482.04892966361,29353.728489483747,139826.41221374046
87,NYC-Manhattan Community District 8--Upper East Side PUMA,3954,2046,1908,108807.44284269094,139006.10948191595,76424.59591194968,3033,1502,1531,124557.74118034949,171259.58721704394,78740.5153494448,462,85,377,58885.71428571428,22809.41176470588,67019.62864721485,459,459,0,54979.95642701525,54979.95642701525,0.0
88,"Chenango, Delaware & Broome (East) Counties PUMA",426,263,163,37243.45070422535,39840.874524714825,33052.51533742331,110,67,43,64434.181818181816,81858.20895522388,37285.11627906977,244,127,117,28918.647540983606,26057.87401574803,32023.931623931625,72,69,3,23913.88888888889,24410.144927536232,12500.0
89,"NYC-Queens Community District 5--Ridgewood, Glendale & Middle Village PUMA",11809,6208,5601,52729.263019730715,55733.767235824744,49399.150151758615,2824,1381,1443,67311.43059490086,63719.17451122375,70749.34164934164,7895,4119,3776,49648.45940468651,55803.65307113377,42934.14724576271,1090,708,382,37264.036697247706,39751.12994350283,32654.450261780104
90,NYC-Brooklyn Community District 18--Canarsie & Flatlands PUMA,2655,1462,1193,49468.866290018836,50763.10533515732,47882.799664710816,659,254,405,69222.00303490137,64433.85826771653,72224.93827160494,1709,997,712,44570.181392627266,50445.4964894684,36343.089887640446,287,211,76,33282.57839721254,35807.10900473934,26273.684210526317
91,Monroe County (Central)--Rochester City (West) PUMA,2422,1207,1215,35282.57638315442,41304.3082021541,29300.493827160495,544,357,187,57995.404411764706,65222.68907563025,44197.86096256685,1480,608,872,30181.35135135135,32670.394736842107,28445.871559633026,398,242,156,23207.286432160803,27711.570247933883,16219.871794871795
92,Erie County (Northwest) PUMA,1234,718,516,47770.42139384117,54033.56545961003,39055.426356589145,520,329,191,67092.11538461539,67138.29787234042,67012.56544502618,608,349,259,34695.06578947369,41775.358166189115,25154.440154440155,106,40,66,27983.01886792453,53200.0,12700.0
93,NYC-Queens Community District 4--Elmhurst & South Corona PUMA,3901,2260,1641,37226.50602409639,36754.11504424779,37877.087141986594,1139,536,603,51245.302897278314,48336.19402985075,53831.17744610282,2463,1526,937,31937.1904181892,33865.79292267366,28796.264674493064,299,198,101,27394.314381270902,27661.11111111111,26871.287128712873
94,"Otsego, Schoharie, Oneida (South) & Herkimer (South) Counties PUMA",563,314,249,38551.651865008884,39583.31210191083,37250.6827309237,80,34,46,71447.5,83147.05882352941,62800.0,454,251,203,34277.04845814978,36554.42231075697,31461.18226600985,29,29,0,14724.137931034482,14724.137931034482,0.0
95,Suffolk County (Central)--Islip Town (Northwest) PUMA,6303,3637,2666,44074.226558781535,44111.24553203189,44023.72468117029,885,353,532,61859.43502824859,62381.86968838527,61512.78195488722,4189,2621,1568,42370.05251850084,44688.515833651276,38494.61096938775,1229,663,566,37075.752644426364,32101.35746606335,42902.65017667844
96,Rensselaer County--Troy City PUMA,1449,840,609,40916.61145617667,41941.380952380954,39503.13628899836,323,183,140,57720.37151702787,52899.234972677594,64022.28571428572,1049,633,416,36998.75119161106,39226.224328594,33609.35096153846,77,24,53,23802.597402597403,30000.0,20996.22641509434
97,"NYC-Queens Community District 13--Queens Village, Cambria Heights & Rosedale PUMA",4423,2124,2299,56813.017408998414,57830.37664783427,55873.099608525445,1355,579,776,68652.45461254612,78199.03281519862,61529.427835051545,2881,1507,1374,52317.59111419646,50938.07564698075,53830.6404657933,187,38,149,40282.994652406414,20810.526315789473,45249.12751677852
98,Erie County (West Central)--Buffalo City (West) PUMA,3633,1856,1777,39240.9083402147,39190.237068965514,39293.83230163196,712,218,494,65079.269662921346,60413.02752293578,67138.46153846153,2412,1333,1079,35007.53731343283,38396.42910727682,30820.889712696942,509,305,204,23158.349705304518,27490.491803278688,16681.37254901961
99,Suffolk County (Central)--Brookhaven Town (Central) PUMA,3849,2181,1668,54726.28215120811,59988.445667125176,47845.71942446043,732,244,488,65407.92349726776,63086.065573770495,66568.85245901639,2873,1805,1068,53319.477897667944,59641.9944598338,42633.95131086143,244,132,112,39245.901639344265,59000.0,15964.285714285714
100,Cayuga & Onondaga (South) Counties PUMA,487,258,229,56306.18480492813,55124.34108527132,57637.694323144104,204,39,165,76291.17647058824,96153.84615384616,71596.36363636363,207,147,60,49152.23188405797,59869.93197278911,22893.866666666665,76,72,4,22147.36842105263,23211.11111111111,3000.0
101,Sullivan & Ulster (West) Counties PUMA,2260,1251,1009,36905.96460176991,33040.11191047162,41699.008919722495,256,103,153,73547.1875,41724.077669902916,94970.58823529411,1600,948,652,34091.0,33345.88607594937,35174.386503067486,404,200,204,24836.138613861385,27118.5,22598.529411764706
102,Chemung (South) & Steuben (East) Counties--Greater Elmira & Greater Corning Cities PUMA,653,437,216,47574.57886676876,52543.24942791762,37522.22222222222,284,148,136,55601.40845070423,76162.16216216216,33226.470588235294,343,263,80,43155.102040816324,42647.14828897338,44825.0,26,26,0,18200.0,18200.0,0.0
103,"NYC-Brooklyn Community District 17--East Flatbush, Farragut & Rugby PUMA",1314,614,700,47008.26484018265,41461.009771986974,51874.0,279,52,227,61628.31541218638,70615.38461538461,59569.603524229075,999,548,451,43363.12312312312,38604.12408759124,49145.67627494457,36,14,22,34855.555555555555,45000.0,28400.0
104,Rockland County (North)--New City & Congers PUMA,3730,1886,1844,59712.40214477212,65634.44326617179,53655.47722342733,1405,510,895,76410.53380782918,99901.96078431372,63024.357541899444,2022,1195,827,52344.78733926805,54725.99163179917,48903.99032648126,303,181,122,31449.83498349835,41099.447513812156,17133.60655737705
105,Saratoga County (Outer) PUMA,786,458,328,51105.29262086514,50477.20524017467,51982.31707317073,372,172,200,66198.81720430107,71338.13953488372,61779.0,386,258,128,38009.326424870465,38671.317829457366,36675.0,28,28,0,31114.285714285714,31114.285714285714,0.0
106,Nassau County (Central)--Hempstead Town (North Central)--Meadowbrook Corridor PUMA,3760,1946,1814,50332.17287234042,52074.419321685506,48463.14773980154,1216,619,597,60665.39473684211,61859.32148626818,59427.47068676717,2321,1157,1164,46809.801809564844,49500.08643042351,44135.69587628866,223,170,53,30647.08520179372,33966.470588235294,20000.0
107,Putnam County PUMA,2376,1079,1297,68397.49579124579,76593.32715477294,61579.22127987664,986,480,506,91723.68154158215,90359.79166666667,93017.49011857707,1266,521,745,52086.49289099526,68802.49520153551,40396.5100671141,124,78,46,49446.77419354839,43915.38461538462,58826.086956521736
108,NYC-Brooklyn Community District 11--Bensonhurst & Bath Beach PUMA,3503,2041,1462,46377.082500713674,47901.920627143554,44248.35841313269,686,239,447,62265.74344023324,70474.05857740586,57876.95749440716,2246,1451,795,47946.58058771148,50096.22329427981,44023.14465408805,571,351,220,21114.88616462347,23461.25356125356,17371.363636363636
109,Orange County (Southeast) PUMA,3848,2105,1743,63933.67983367983,68313.88123515439,58643.7636259323,1120,420,700,74420.98214285714,75378.57142857143,73846.42857142857,2646,1603,1043,60618.02721088436,68541.31004366813,48440.632790028765,82,82,0,27682.926829268294,27682.926829268294,0.0
110,Onondaga County (Central)--Syracuse City (Outer) PUMA,870,515,355,62745.55172413793,73324.07766990291,47399.23943661972,425,281,144,89521.81176470588,106571.53024911032,56251.180555555555,376,231,145,37284.46808510638,33787.01298701299,42856.275862068964,69,3,66,36563.76811594203,3500.0,38066.666666666664
111,"Rockland County (West)--Spring Valley, Suffern Villages & Monsey PUMA",918,508,410,54658.12636165577,55604.44881889764,53485.60975609756,276,155,121,54859.637681159424,53679.096774193546,56371.90082644628,541,252,289,58101.478743068394,64780.95238095238,52277.16262975778,101,101,0,35663.36633663366,35663.36633663366,0.0
112,Monroe County (East) PUMA,1654,943,711,40496.553808948,42182.078472958645,38261.04078762307,237,44,193,45667.08860759494,34547.72727272727,48202.072538860106,1124,729,395,43450.0,47501.50891632373,35972.6582278481,293,170,123,24984.30034129693,21347.058823529413,30011.38211382114
113,NYC-Manhattan Community District 10--Central Harlem PUMA,6034,3041,2993,52547.2124627113,58554.50180861559,46443.58169061143,2169,1196,973,87176.78192715537,98842.00668896321,72838.02672147995,2750,1002,1748,38207.832727272726,42294.51097804391,35865.24027459954,1115,843,272,20548.789237668163,20723.724792408066,20006.617647058825
114,Nassau County (Southwest)--Hempstead Town (Southwest) & Long Beach City PUMA,2039,1251,788,62773.95782246199,68443.24540367707,53773.604060913705,740,255,485,80264.72972972973,110188.23529411765,64531.75257731959,1167,902,265,55552.8706083976,60690.13303769402,38066.79245283019,132,94,38,28560.60606060606,29595.744680851065,26000.0
115,Nassau County (Southeast)--Oyster Bay Town (South) PUMA,2269,1248,1021,72308.60290877038,75223.03685897436,68746.19980411361,1029,446,583,80530.48590864918,82772.64573991031,78815.21440823328,1190,768,422,65506.17647058824,71291.34114583333,54977.72511848341,50,34,16,65000.0,65000.0,65000.0
116,Wayne & Seneca Counties PUMA,721,362,359,31626.42163661581,31136.46408839779,32120.473537604455,207,74,133,43630.19323671498,56154.05405405405,36662.03007518797,426,200,226,28881.220657276994,28241.0,29447.78761061947,88,88,0,16679.545454545456,16679.545454545456,0.0
117,Schenectady County--Schenectady City PUMA,1841,968,873,41616.27865290603,48344.12086776859,34156.31156930126,370,231,139,89222.61891891892,99965.40692640693,71369.4964028777,1335,714,621,30001.2734082397,32475.63025210084,27156.360708534623,136,23,113,26113.970588235294,22500.0,26849.557522123894
118,"NYC-Brooklyn Community District 9--Crown Heights South, Prospect Lefferts & Wingate PUMA",1718,932,786,50571.338766006986,47268.7982832618,54487.32824427481,769,327,442,59413.34200260078,53741.95718654434,63609.14027149321,902,558,344,44084.25720620843,44896.41577060932,42766.86046511628,47,47,0,30397.872340425532,30397.872340425532,0.0
119,"NYC-Manhattan Community District 4 & 5--Chelsea, Clinton & Midtown Business District PUMA",4834,2992,1842,105329.21514273893,110524.50868983957,96890.38870792616,2540,1601,939,135973.96692913387,116759.0755777639,168735.45899893504,2205,1336,869,73847.18820861678,107426.30988023953,22222.669735327963,89,55,34,10724.719101123595,4300.0,21117.647058823528
120,Westchester County (Northeast) PUMA,2004,1128,876,91410.40918163673,95565.39007092199,86060.1598173516,1306,687,619,113073.39969372128,129754.67248908296,94559.61227786753,560,303,257,55393.392857142855,46745.87458745875,65588.71595330739,138,138,0,32552.898550724636,32552.898550724636,0.0
121,Nassau County (South Central)--Hempstead Town (Southeast) PUMA,2947,1359,1588,70487.78758059043,79308.4400294334,62939.13098236776,1132,514,618,96934.03710247349,111448.38521400778,84862.23300970874,1696,826,870,57163.372641509435,60744.06779661017,53763.77011494253,119,19,100,8815.966386554623,16900.0,7280.0
122,NYC-Queens Community District 2--Sunnyside & Woodside PUMA,4523,2554,1969,50191.65155869998,54369.581049334374,44772.43778567801,1805,864,941,62804.52077562327,71985.3125,54374.9734325186,2354,1435,919,42980.875106202206,46607.24738675958,37318.36779107726,364,255,109,34279.395604395606,38365.490196078434,24720.183486238533
123,"NYC-Staten Island Community District 3--Tottenville, Great Kills & Annadale PUMA",3905,2180,1725,65305.85659411012,64668.07339449541,66111.86666666667,1340,424,916,85245.35074626865,89157.07547169812,83434.68340611353,2440,1683,757,56435.65573770492,59617.4688057041,49361.690885072654,125,73,52,24700.8,38871.232876712325,4807.692307692308
124,Suffolk County (Central)--Brookhaven Town (West Central) PUMA,2532,1378,1154,55787.66982622433,53399.67343976778,58639.19410745234,687,254,433,78807.97671033478,93121.85039370079,70411.38568129331,1415,851,564,51555.83038869258,47667.45005875441,57422.87234042553,430,273,157,32934.41860465116,34310.62271062271,30541.40127388535
125,NYC-Queens Community District 9--Richmond Hill & Woodhaven PUMA,8510,4391,4119,49648.70528789659,51881.15190161694,47268.838067492106,2108,903,1205,71475.51233396585,81863.30011074197,63691.13692946058,5679,2987,2692,44653.738686388446,46950.35754938065,42105.44725111441,723,501,222,25244.14937759336,27239.241516966067,20741.711711711712
126,Suffolk County (Northwest)--Huntington Town (South) PUMA,906,446,460,80835.16556291391,93132.73542600896,68911.86956521739,443,177,266,105981.62528216705,148324.29378531073,77806.24060150376,405,257,148,62056.2962962963,59096.49805447471,67195.94594594595,58,12,46,19896.55172413793,8000.0,23000.0
127,"NYC-Bronx Community District 3 & 6--Belmont, Crotona Park East & East Tremont PUMA",10693,5105,5588,36098.012718600956,39432.81684622919,33051.45311381532,1754,563,1191,50975.88369441277,63761.989342806395,44931.73803526448,6734,3473,3261,36501.22215622215,40287.598617909585,32468.690585709905,2205,1069,1136,23031.800453514737,23842.563143124415,22268.855633802817
128,Suffolk County (North Central)--Brookhaven Town (North) PUMA,1900,922,978,67535.96842105263,74266.05206073752,61191.24744376278,657,278,379,86564.44444444444,88800.35971223022,84924.37994722955,1120,521,599,56517.41071428572,68408.4452975048,46174.79131886477,123,123,0,66227.64227642276,66227.64227642276,0.0
129,NYC-Queens Community District 1--Astoria & Long Island City PUMA,6938,3893,3045,57745.57221101182,58936.85846390958,56222.52545155994,3198,1444,1754,79765.64727954972,92805.94875346261,69030.0741163056,2885,1782,1103,41450.23916811092,42807.01459034792,39258.24116047144,855,667,188,30367.602339181285,28706.596701649174,36260.63829787234
130,Nassau County (West Central)--Hempstead Town (Northwest) PUMA,2618,1589,1029,71676.25668449198,81650.30837004405,56274.14965986394,933,519,414,106887.62057877814,133685.83815028903,73292.7536231884,1389,862,527,53800.791936645066,60967.053364269144,42079.127134724855,296,208,88,44570.91216216216,37527.83653846154,61218.181818181816
131,Westchester County (Southeast) PUMA,2221,1457,764,69145.97028365602,72814.3445435827,62150.13089005236,820,396,424,103039.0243902439,135203.53535353535,72998.58490566038,1243,918,325,50153.8213998391,50963.94335511982,47865.53846153846,158,143,15,42658.22784810127,40314.68531468532,65000.0
132,"NYC-Bronx Community District 10--Co-op City, Pelham Bay & Schuylerville PUMA",12142,5849,6293,55183.170812057324,59744.14429817063,50943.994914984905,3645,1156,2489,69719.01234567902,95365.65743944637,57807.593411008434,7627,3997,3630,50320.04195620821,53440.38028521391,46884.23140495868,870,696,174,36916.4367816092,36781.03448275862,37458.0459770115
133,Suffolk County (South Central)--Brookhaven Town (South) PUMA,3076,1588,1488,63839.590377113134,58035.95717884131,70033.25268817204,712,247,465,93951.54494382022,114716.5991902834,82921.50537634408,2202,1249,953,56584.9591280654,49400.4003202562,66001.02833158447,162,92,70,30104.938271604937,23097.82608695652,39314.28571428572
134,Onondaga County (Central)--Syracuse City PUMA,1607,760,847,33857.63534536403,36877.68421052631,31147.79220779221,372,175,197,52216.23655913978,69502.5142857143,36860.40609137056,747,321,426,29751.78045515395,26937.383177570093,31872.4882629108,488,264,224,26147.950819672133,27337.878787878788,24745.535714285714
135,Suffolk County (West Central)--Babylon Town (Northwest) PUMA,3862,2208,1654,52203.12066286898,56175.23188405797,46900.56831922612,939,468,471,76019.21192758254,88025.64102564103,64089.25690021231,2427,1379,1048,48609.84754841368,52856.63524292966,43021.75572519084,496,361,135,24698.209677419356,27561.252077562327,17042.222222222223
136,Suffolk County (Southwest)--Islip Town (South) PUMA,3405,2073,1332,66414.8135095448,71815.09889049687,58010.31531531532,1125,435,690,83898.34666666666,116429.88505747127,63389.333333333336,1946,1356,590,62333.196300102776,65901.84365781711,54131.35593220339,334,282,52,31306.586826347306,31428.36879432624,30646.153846153848
137,Niagara County (North & East) PUMA,637,354,283,42132.65306122449,45559.32203389831,37846.28975265018,253,95,158,43363.63636363636,62547.36842105263,31829.113924050635,302,177,125,43827.15231788079,42679.661016949154,45452.0,82,82,0,32093.90243902439,32093.90243902439,0.0
138,NYC-Manhattan Community District 11--East Harlem PUMA,6866,3325,3541,43847.1249635887,45133.082706766916,42639.61027958204,2106,702,1404,52564.15004748338,53162.67806267806,52264.88603988604,4060,2181,1879,42713.137931034486,48125.03438789546,36431.420968600316,700,442,258,24198.457142857143,17616.742081447963,35474.108527131786
139,Broome (Outer West) & Tioga Counties PUMA,356,178,178,48096.98314606742,51916.29213483146,44277.67415730337,67,11,56,88447.76119402985,130000.0,80285.71428571429,167,77,90,38739.077844311374,49194.805194805194,29793.62222222222,122,90,32,38746.72131147541,44701.11111111111,22000.0
140,Albany County (East Central)--Albany City PUMA,2065,1003,1062,46794.4794188862,52822.432701894315,41101.41242937853,692,303,389,70925.57803468208,83255.77557755775,61321.33676092545,1244,623,621,36241.72025723472,42194.86356340289,30269.40418679549,129,77,52,19111.627906976744,19051.948051948053,19200.0
141,Nassau County (West Central)--Hempstead Town (West Central) PUMA,3791,2039,1752,69256.23503033501,72351.82785679254,65653.54452054795,1466,500,966,93385.06821282402,122062.8,78541.52173913043,2037,1268,769,57937.24938635248,63804.63485804416,48262.54876462939,288,271,17,26492.01388888889,20626.19926199262,120000.0
142,Nassau County (West Central)--North Hempstead Town (South) PUMA,2272,1288,984,58789.15404929577,62042.77173913043,54530.35365853659,756,442,314,76380.23544973545,84629.84162895927,64767.732484076434,1270,672,598,54461.259842519685,55626.041666666664,53152.341137123745,246,174,72,27071.951219512193,29448.275862068964,21329.166666666668
143,Nassau County (Central)--Hempstead Town (Northeast) PUMA,2366,1112,1254,65699.20540997465,69008.4892086331,62764.65709728868,938,281,657,84816.50319829425,109367.25978647686,74316.10350076103,1300,737,563,53885.876923076925,55682.008141112616,51534.63587921847,128,94,34,45584.375,52846.8085106383,25505.882352941175
144,Nassau County (Central)--Hempstead Town (East Central) PUMA,1469,887,582,74025.47311095984,78127.86922209695,67773.19587628866,635,262,373,84368.03149606299,97951.14503816795,74827.07774798927,736,527,209,71902.33695652174,78532.48576850095,55184.21052631579,98,98,0,22955.102040816328,22955.102040816328,0.0
145,"NYC-Bronx Community District 5--Morris Heights, Fordham South & Mount Hope PUMA",6706,2875,3831,35215.21771547868,36579.24173913043,34191.576611850694,1435,440,995,46982.648083623695,54883.63636363636,43488.74371859297,4264,1740,2524,32419.469981238275,32239.35632183908,32543.63708399366,1007,695,312,30284.538232373387,35856.17266187051,17873.365384615383
146,Capital Region,9994,5272,4722,378653.63131851505,402132.75682010537,356082.74310823146,3175,1585,1590,537249.380894794,524114.59069583437,487305.5946679638,6051,3226,2825,320292.7060103091,343493.69153106253,290871.99644911697,768,461,307,225066.75447566336,214930.10947244844,200670.78393721822
147,Central NY,4688,2648,2040,283680.86104336183,308029.4560604469,245001.71425615405,1571,816,755,404234.0303348682,502888.6505670902,310858.7664344925,2380,1412,968,219280.13770172585,237107.26846448003,183671.67400431138,737,420,317,146446.07415138467,119232.20903279725,80712.20238095238
148,Finger Lakes,15394,8630,6764,399011.5978173588,429112.6925533203,345889.5254891231,3376,1769,1607,552675.0516570807,598829.7480067802,494005.9217589976,9493,5112,4381,355532.5315986155,380065.1808515569,306059.46421872394,2525,1749,776,190850.2633295274,198694.07088551152,117363.03466010827
149,Long Island,63249,35562,27687,1658133.751094101,1762895.737960995,1505275.938023281,20235,8760,11475,2258650.4753411654,2658611.5119765773,1880355.3006030084,37407,22987,14420,1386479.379304616,1478473.6177335212,1221469.659699107,5607,3815,1792,869655.5566088351,872137.0391844795,728588.6742297454
150,Mid-Hudson,61513,32939,28574,1045854.925821239,1122079.5377955746,964536.8443260086,22023,9732,12291,1384037.7279640594,1531915.8936608464,1254847.5462241261,34676,19957,14719,879849.9748121208,976266.1256746069,773106.1585052967,4814,3250,1564,574447.3204038186,558555.3407427405,519019.1538021151
151,Mohawk Valley,3842,2037,1805,140837.73267709737,140673.98309571264,142092.46873605705,548,168,380,205199.86490233545,231352.60468717915,194518.42918454937,2658,1462,1196,132172.70544764627,142115.00548334565,120039.59027577307,636,407,229,106460.14278851877,90908.21478984818,114858.13065861886
152,New York City,320570,166463,154107,3012561.0209630555,3160164.9791558655,2841172.7589097875,100788,43227,57561,3964481.8525930266,4479120.134278591,3623376.2366031543,183082,98737,84345,2468250.676575344,2593497.966477372,2277163.2651409893,36700,24499,12201,1999505.621413068,2131192.346856795,1729292.3208833565
153,North Country,2348,1756,592,109990.59309110224,98597.50283510835,131998.77479526034,454,181,273,159246.3428397564,153908.9306365493,170644.15584415584,1598,1318,280,106995.43376041717,108294.17308186869,110319.26129180027,296,257,39,62521.96153846154,64674.07692307692,26664.102564102563
154,Southern Tier,3424,1781,1643,240890.10204070434,248189.4694441865,226376.10219313938,1140,546,594,336702.42098163243,404181.9979846277,288480.6215441611,1961,1025,936,210166.24254331744,216931.07654891163,207393.3227178909,323,210,113,159736.3677761219,140611.25603864732,91469.23076923077
155,Western NY,12636,6945,5691,455727.8775011284,468260.8368779861,434519.1053941291,3070,1389,1681,635518.7155300827,716823.5121569248,534883.6694145302,7705,4285,3420,426261.6216099204,450351.46478966036,398958.6830132007,1861,1271,590,242665.97333464105,271898.37377314956,126696.19457518328
