,puma,Total_geo,Total_geo_m,Total_geo_f,Total_Avg_PINCP_mf_t,Total_Avg_PINCP_m,Total_Avg_PINCP_f,Total_BABS,Total_BABS_m,Total_BABS_f,BABS_Avg_PINCP_mf_t,BABS_Avg_PINCP_m,BABS_Avg_PINCP_f,Total_HS,Total_HS_m,Total_HS_f,HS_Avg_PINCP_mf_t,HS_Avg_PINCP_m,HS_Avg_PINCP_f,Total_HSINC,Total_HSINC_m,Total_HSINC_f,HSINC_Avg_PINCP_mf_t,HSINC_Avg_PINCP_m,HSINC_Avg_PINCP_f
0,Total Geo,3619934,2035692,1584242,79195.94735069755,90152.31857520685,65117.41815454962,1785840,932545,853295,106051.21477343995,127289.49047391815,82840.42857042406,1736927,1028567,708360,53719.24714740458,59993.02066564453,44609.47752978712,97167,74580,22587,41034.40773101979,41731.48999731831,38732.71226811883
1,"NYC-Manhattan Community District 6--Murray Hill, Gramercy & Stuyvesant Town PUMA",45751,23176,22575,155346.49834976284,176347.4562478426,133786.44518272424,41015,20744,20271,161160.01331220285,186530.39654839953,135197.6419515564,4736,2432,2304,104999.9366554054,89490.99506578948,121370.48611111111,0,0,0,#DIV/0!,0.0,0.0
2,Tompkins County PUMA,23516,11948,11568,62869.70500935533,72323.90190826917,53104.94493430152,13143,6481,6662,79839.82903446701,95628.70853263386,64479.91789252477,9628,5031,4597,42547.975695887,45410.717551182664,39414.964107026324,745,436,309,26117.046979865772,36456.422018348625,11528.155339805826
3,Westchester County (South Central)--New Rochelle & Mount Vernon Cities PUMA,26872,15513,11359,132137.53401309912,154408.2363179269,101722.40901487807,17557,10183,7374,171036.77245543088,201734.23058037905,128645.63927312178,8963,4978,3985,59925.60526609394,66348.192044998,51902.60978670012,352,352,0,30664.772727272728,30664.772727272728,0.0
4,"NYC-Queens Community District 7--Flushing, Murray Hill & Whitestone PUMA",17608,11322,6286,75311.45899591094,74011.06429959371,77653.65892459433,8467,4764,3703,79930.57399314988,70879.59068010075,91574.88522819335,8995,6412,2583,71573.9244024458,77164.43387398627,57696.1285327139,146,146,0,37702.397260273974,37702.397260273974,0.0
5,Madison & Cortland Counties PUMA,37867,21181,16686,50397.73911321203,55697.42368160144,43670.385712573414,12508,6119,6389,70922.51519027822,81053.0838372283,61220.06573798716,23945,13928,10017,40944.09968678221,46595.20469557725,33086.598382749326,1414,1134,280,28929.20792079208,30674.867724867723,21859.285714285714
6,NYC-Brooklyn Community District 5--East New York & Starrett City PUMA,686,155,531,58214.28571428572,132000.0,36676.08286252354,261,0,261,32869.73180076628,0.0,32869.73180076628,425,155,270,73778.82352941176,132000.0,40355.555555555555,0,0,0,#DIV/0!,0.0,0.0
7,Dutchess County (Southwest) PUMA,38147,20978,17169,68406.1756363541,77715.36643149967,57031.70976760441,17321,8849,8472,88374.2962877432,104417.35190416996,71617.33227101038,20019,11841,8178,51709.885408861584,58179.39447681783,42342.624847150895,807,288,519,54001.239157372984,60491.666666666664,50399.61464354528
8,"NYC-Bronx Community District 3 & 6--Belmont, Crotona Park East & East Tremont PUMA",434,127,307,60216.22119815668,93800.0,46323.25732899023,234,62,172,70005.29914529914,125000.0,50181.62790697674,200,65,135,48763.0,64040.0,41407.40740740741,0,0,0,#DIV/0!,0.0,0.0
9,Dutchess County (North & East) PUMA,35949,19731,16218,68793.25906144816,72950.733414424,63735.22931310889,15342,7379,7963,90693.08421327076,99670.32877083616,82374.22353384402,19459,11505,7954,53471.704712472376,58640.04302477184,45996.00289162686,1148,847,301,35827.238675958186,34557.10743801653,39401.32890365449
10,Erie County (Central) PUMA,48382,25893,22489,54562.42251250465,63246.89221024988,44563.44639601583,14021,6711,7310,70094.70194707937,87415.37326776933,54193.33050615595,33547,18604,14943,48486.80150236981,55312.708557299506,39988.563206852705,814,578,236,37413.48894348894,38009.653979238756,35953.38983050847
11,Suffolk County (West Central)--Babylon Town (Northwest) PUMA,16471,9166,7305,71019.50336955862,80120.70041457561,59599.71252566735,6012,3033,2979,94119.10179640718,102580.82756346851,85503.991272239,9482,5465,4017,60865.18245095971,74122.05855443733,42829.62658700523,977,668,309,27425.322415557832,27218.02395209581,27873.462783171522
12,"Otsego, Schoharie, Oneida (South) & Herkimer (South) Counties PUMA",32612,19377,13235,51424.56028455783,58559.67033080456,40978.24163203627,10326,5184,5142,74922.02576021693,96070.35609567902,53600.95527032283,20924,13191,7733,41593.3656088702,46334.97581684482,33505.09711625501,1362,1002,360,24312.29074889868,25426.487025948103,21211.11111111111
13,NYC-Brooklyn Community District 7--Sunset Park & Windsor Terrace PUMA,10544,5619,4925,73863.19850151746,85882.68766684463,60149.998578680206,8086,3750,4336,80622.76094484294,99187.11253333333,64567.33694649446,2331,1742,589,53508.37408837409,62257.893226176806,27631.18845500849,127,127,0,17085.826771653545,17085.826771653545,0.0
14,Westchester County (Northeast) PUMA,33378,19179,14199,160003.56791898856,202882.0240888472,102086.39692936122,25349,14306,11043,174406.52254526806,231504.61973996923,100437.00534275106,7669,4783,2886,116539.0728908593,120204.73552163914,110463.92931392931,360,90,270,71750.0,47000.0,80000.0
15,Nassau County (East Central)--Oyster Bay Town (Central) PUMA,22080,13864,8216,101542.32291666667,117340.16084824005,74884.43281402142,13391,8109,5282,127510.24942125309,153519.40189912444,87580.63612268081,8332,5581,2751,63158.63418146904,67686.82314997312,53972.22101054162,357,174,183,23324.929971988797,23879.310344827587,22797.814207650274
16,Niagara County (Southwest)--Greater Niagara Falls & North Tonawanda Area PUMA,28136,16919,11217,53367.4424936025,59108.91482948165,44707.37559062138,9112,5806,3306,72774.73222124671,81983.07440578712,56603.03387779794,18077,10617,7460,44922.27703711899,47556.27766789112,41173.5927613941,947,496,451,27838.43717001056,38639.1129032258,15960.088691796009
17,Nassau County (Central)--Hempstead Town (East Central) PUMA,30488,17682,12806,97871.58990422462,112038.57612261057,78310.39590816805,16423,7946,8477,113178.73671071058,140729.8707525799,87353.40804529905,13024,9069,3955,74023.00675675676,79261.72124820818,62010.38938053097,1041,667,374,154754.08261287224,215895.05247376312,45713.90374331551
18,Niagara County (North & East) PUMA,34790,19413,15377,55642.765737280824,63474.89434914748,45754.93893477271,12365,6845,5520,71558.96449656288,80726.18407596786,60191.28007246377,21859,12202,9657,46556.60021043964,53444.54958203573,37853.40478409444,566,366,200,58841.87279151943,75237.70491803279,28837.5
19,"NYC-Queens Community District 13--Queens Village, Cambria Heights & Rosedale PUMA",6595,3468,3127,81138.39272175891,97810.19896193771,62648.522545570835,2635,1431,1204,87799.45730550284,101855.18518518518,71093.68770764119,3960,2037,1923,76706.09343434343,94968.58124693176,57360.96203848154,0,0,0,#DIV/0!,0.0,0.0
20,"Chenango, Delaware & Broome (East) Counties PUMA",34584,19491,15093,44870.75433726579,49189.8965676466,39293.042735042734,7190,2672,4518,57550.93184979138,70530.60628742515,49874.594953519256,24695,14517,10178,42282.76444624418,47413.218571330166,34965.137944586364,2699,2302,397,34770.692849203406,35623.28410078193,29826.952141057933
21,Oswego County PUMA,37603,21904,15699,49057.71475680132,53146.595781592405,43352.71125549398,10114,4811,5303,68126.5928416057,75778.7445437539,61184.389967942676,25377,15399,9978,41860.06809315522,46620.69446067927,34513.01603527761,2112,1694,418,44224.40340909091,48193.28217237308,28140.0
22,"NYC-Brooklyn Community District 9--Crown Heights South, Prospect Lefferts & Wingate PUMA",7679,4501,3178,62974.96809480401,71606.47633859143,50750.16677155444,6081,3292,2789,69120.10853478046,82667.17800729041,53129.80638221585,1598,1209,389,39590.362953692114,41489.16459884202,33688.94601542417,0,0,0,#DIV/0!,0.0,0.0
23,NYC-Queens Community District 10--Howard Beach & Ozone Park PUMA,6246,3189,3057,57296.40409862312,59989.31953590467,54487.20968269545,2315,884,1431,60842.98056155507,61799.20814479638,60252.27113906359,3664,2038,1626,54435.54585152838,58442.31599607458,49413.53013530136,267,267,0,65805.24344569289,65805.24344569289,0.0
24,Ontario & Yates Counties PUMA,41779,24513,17266,57227.45676057349,66849.49333006976,43566.79520444805,13238,6536,6702,87466.91312887143,121971.67380660954,53816.79140555058,24769,15096,9673,44710.45920303605,48555.32684154743,38710.03308177401,3772,2881,891,33294.1558854719,37654.8267962513,19194.16386083053
25,"NYC-Bronx Community District 8--Riverdale, Fieldston & Kingsbridge PUMA",10043,5932,4111,120603.38683660261,142873.11766689143,88469.10240817319,7774,4521,3253,139005.76459994854,169256.12342402124,96963.99631109745,1962,1104,858,63429.66360856269,69000.36231884058,56261.77156177156,307,307,0,20000.0,20000.0,0.0
26,Erie County (Northwest) PUMA,34499,19183,15316,52757.1900634801,58021.77391440338,46163.39847218595,14318,6881,7437,68889.92876100013,84909.13675337887,54068.33803953207,19578,11883,7695,41594.02390438247,43409.52781284187,38790.43287849253,603,419,184,32133.499170812604,30874.70167064439,35000.0
27,NYC-Brooklyn Community District 14--Flatbush & Midwood PUMA,15717,8918,6799,80793.05338168862,94295.0627943485,63082.96072951904,11380,6362,5018,90291.73110720562,104753.874567746,71956.10801115983,4049,2344,1705,58600.434675228455,73441.91979522184,38196.6568914956,288,212,76,17470.0,10996.981132075472,35526.31578947369
28,"Rockland County (West)--Spring Valley, Suffern Villages & Monsey PUMA",12011,7163,4848,70236.80126550661,77655.40695239425,59275.68894389439,5743,3167,2576,94980.54327006791,114753.96905588885,70670.5900621118,5340,3105,2235,48039.93632958802,48806.81481481482,46974.54138702461,928,891,37,44835.88362068965,46324.017957351294,9000.0
29,"NYC-Manhattan Community District 1 & 2--Battery Park City, Greenwich Village & Soho PUMA",50497,28732,21765,177648.01988236926,213460.76743700405,130371.57316793017,46166,25706,20460,182309.137893688,221960.51777795068,132491.03567937438,4331,3026,1305,127963.14938813206,141255.02313284864,97142.29885057472,0,0,0,#DIV/0!,0.0,0.0
30,"NYC-Bronx Community District 4--Concourse, Highbridge & Mount Eden PUMA",236,236,0,33807.20338983051,33807.20338983051,0.0,0,0,0,#DIV/0!,0.0,0.0,236,236,0,33807.20338983051,33807.20338983051,0.0,0,0,0,#DIV/0!,0.0,0.0
31,NYC-Queens Community District 1--Astoria & Long Island City PUMA,29748,16107,13641,61350.833669490385,67163.12149996895,54487.80895828752,22538,11519,11019,66927.86050226285,73126.31461064328,60448.14429621563,6794,4503,2291,45926.74124227259,53082.25183211193,31862.461807071148,416,85,331,11101.442307692309,5000.0,12668.277945619335
32,Erie County (West Central)--Buffalo City (West) PUMA,23344,13716,9628,55864.17469156957,61359.54418197725,48035.49916909015,13527,7728,5799,68225.32594071118,75099.79399585922,59064.110363855834,8974,5489,3485,39983.2081568977,44690.8908726544,32568.439024390245,843,499,344,26571.7674970344,31919.839679358716,18813.95348837209
33,Schenectady County--Schenectady City PUMA,42399,21574,20825,57335.63423665652,62714.8602947993,51762.9368547419,17006,7562,9444,75749.38962719041,89742.45702195186,64544.86022871664,24385,13175,11210,45291.90633586221,48601.36136622391,41402.33719892953,1008,837,171,38032.043650793654,40686.97729988053,25036.842105263157
34,NYC-Brooklyn Community District 2--Brooklyn Heights & Fort Greene PUMA,28745,15752,12993,119963.11219342494,136160.79291518536,100325.9331947972,25243,13384,11859,123930.81091787822,144439.07725642557,100785.29808584198,3303,2169,1134,89784.49894035725,86784.78561549101,95522.04585537918,199,199,0,117567.8391959799,117567.8391959799,0.0
35,"Steuben (North & West), Schuyler & Chemung (North) Counties PUMA",34505,18310,16195,45945.922330097084,52051.124358274166,39043.406174745294,8013,3604,4409,63290.158492449766,72163.40732519423,56036.997051485596,24646,13207,11439,40303.4695285239,47181.742030741276,32362.09834775767,1846,1499,347,45991.71180931744,46597.66511007338,43374.06340057637
36,NYC-Brooklyn Community District 1--Greenpoint & Williamsburg PUMA,35819,20881,14938,78590.46905273738,85649.61117762559,68722.88659793814,27965,15516,12449,85144.27323440014,94915.20565867491,72966.1233834043,6643,4440,2203,48164.309799789255,48550.51801801802,47385.93281888334,1211,925,286,94151.03220478943,108303.67567567568,48377.62237762238
37,Suffolk County (Northwest)--Huntington Town (North) PUMA,26263,14298,11965,113441.16468034878,135299.5104210379,87320.76122022566,18333,10313,8020,136932.82648775433,161558.49898186754,105266.42244389027,7930,3985,3945,59131.878940731396,67342.43412797993,50838.07351077313,0,0,0,#DIV/0!,0.0,0.0
38,Erie County (Northeast) PUMA,41474,23369,18105,65941.93552587162,76440.47045230861,52390.968240817456,16984,9192,7792,79020.67381064531,92153.31309834639,63528.47407597536,24058,13745,10313,57053.601712528056,66865.83775918516,43976.01182972947,432,432,0,46743.42592592593,46743.42592592593,0.0
39,Monroe County (North & West) PUMA,34509,19263,15246,51712.52931119418,52064.94170170794,51267.26367571822,12826,5338,7488,70174.28598159988,72705.62757587111,68369.75854700855,20442,12986,7456,40823.61911750318,44463.55090097027,34484.0061695279,1241,939,302,40270.63658340048,39851.60809371672,41573.50993377483
40,Oneida County (Central)--Greater Utica & Rome Cities PUMA,36526,18792,17734,55641.76219679133,66374.5055342699,44268.709710161274,13305,6865,6440,78019.99128147314,96292.84107793153,58541.24689440994,22610,11400,11210,42622.778505086244,48804.18894736842,36336.59839429081,611,527,84,50104.746317512276,56720.30360531309,8600.0
41,"NYC-Brooklyn Community District 12--Borough Park, Kensington & Ocean Parkway PUMA",15640,11561,4079,68838.61700767264,73790.81999827005,54802.72125520961,7632,5368,2264,85497.69523060796,90709.42809239941,73140.54770318021,6364,4742,1622,55636.433060967945,63150.81400253058,33667.75585696671,1644,1451,193,42607.846715328466,45972.63955892488,17310.880829015543
42,Erie County (West Central)--Buffalo City (East) PUMA,15410,9626,5784,47045.163659961065,52289.068356534386,38318.01521438451,3091,1752,1339,76256.42510514396,85818.38470319635,63745.18297236744,10681,6381,4300,40566.61941765752,46950.66008462624,31093.0,1638,1493,145,34166.84981684982,35759.276624246486,17770.344827586207
43,Suffolk County (Northwest)--Smithtown Town PUMA,35400,20693,14707,101534.92677966102,114324.26704682743,83540.10675188685,20738,11276,9462,114148.97714340824,130271.67772259667,94935.32551257662,14441,9196,5245,83262.51090644693,94829.01478903872,62983.088655862724,221,221,0,111859.72850678733,111859.72850678733,0.0
44,Nassau County (Northeast)--Oyster Bay Town (North) & Glen Cove City PUMA,23095,14050,9045,166366.43342714873,197828.29323843415,117495.33001658374,16173,9715,6458,199208.56983861994,236369.32166752443,143306.32393930008,6922,4335,2587,89631.98208610229,111455.49250288351,53062.62852725164,0,0,0,#DIV/0!,0.0,0.0
45,NYC-Manhattan Community District 8--Upper East Side PUMA,67477,31710,35767,164272.11255687123,217707.3673604541,116897.94279643247,62486,28386,34100,166552.3659539737,224979.65120129642,117915.50615835778,4991,3324,1667,135723.94309757563,155604.16365824308,96082.75944811037,0,0,0,#DIV/0!,0.0,0.0
46,Suffolk County (Southwest)--Islip Town (South) PUMA,26924,16357,10567,81536.75233991977,88096.5005807911,71382.7065392259,12418,6658,5760,97568.42969882429,105433.76389306098,88476.86805555556,13959,9361,4598,68926.87585070563,77721.3609657088,51022.31404958678,547,338,209,39379.34186471663,33925.44378698225,48199.52153110048
47,"NYC-Brooklyn Community District 6--Park Slope, Carroll Gardens & Red Hook PUMA",35416,18818,16598,130306.18725999548,155170.81794026995,102115.8860103627,31969,16656,15313,135273.4097406863,163438.2060518732,104638.4690132567,3274,2090,1184,86664.10873549175,92907.98660287082,75642.39864864865,173,72,101,38323.69942196532,50000.0,30000.0
48,Erie County (South) PUMA,57657,32141,25516,65975.54253603205,74945.81170467626,54676.223624392536,23069,11495,11574,88278.21821492046,101585.33658112223,75061.92949714878,33754,20201,13553,51501.21407833145,60286.38334735904,38406.75496200103,834,445,389,34879.68824940048,52280.13483146067,14974.293059125965
49,Albany County (Outside Albany City) PUMA,61989,33133,28856,71259.11405249318,80290.13011197296,60889.532159689494,27422,14050,13372,99451.8766319014,115575.95523131672,82510.25949745737,33537,18547,14990,49269.42958523422,54689.63767725239,42563.05203468979,1030,536,494,36663.1067961165,41197.76119402985,31742.914979757086
50,NYC-Staten Island Community District 2--New Springville & South Beach PUMA,19140,9387,9753,69826.74179728318,83964.8213486737,56219.220752588946,7633,3221,4412,77575.2689637102,93837.05929835455,65703.277425204,10377,5238,5139,67419.01416594391,85384.48071783123,49107.4528118311,1130,928,202,39597.0796460177,41686.099137931036,30000.0
51,Erie County (North Central) PUMA,31053,16663,14390,83644.63034167391,89359.95414991298,77026.53161917998,20127,10145,9982,91034.01977443235,99086.19576145885,82850.35664195551,9988,5580,4408,73850.2593111734,81759.29390681004,63838.36887477314,938,938,0,29380.170575692962,29380.170575692962,0.0
52,"NYC-Staten Island Community District 3--Tottenville, Great Kills & Annadale PUMA",37883,19898,17985,76163.91415674577,90787.40627198713,59984.97358910203,16592,7423,9169,89889.42864030859,110885.36306075711,72891.62940342458,20198,11730,8468,66292.65075750074,80809.25490196078,46184.03401039206,1093,745,348,50222.506861848124,47641.87919463087,55747.12643678161
53,"NYC-Manhattan Community District 12--Washington Heights, Inwood & Marble Hill PUMA",14344,7519,6825,81594.54029559398,89332.49049075675,73069.75677655678,11987,5725,6262,82891.50996913323,95056.69694323144,71769.55285851166,2357,1794,563,74998.53882053458,71065.44370122631,87531.34991119006,0,0,0,#DIV/0!,0.0,0.0
54,NYC-Manhattan Community District 7--Upper West Side & West Side PUMA,48750,24625,24125,168415.2196923077,198968.86732994925,137228.33583419689,44528,22432,22096,172020.76693316564,199211.51738587732,144416.5438088342,4222,2193,2029,130388.737565135,196486.82170542635,58948.07787087235,0,0,0,#DIV/0!,0.0,0.0
55,"NYC-Queens Community District 5--Ridgewood, Glendale & Middle Village PUMA",19469,10610,8859,75202.30006677282,86120.65692742696,62125.90698724461,8633,4291,4342,97220.02548360941,119309.12141691914,75390.38231229848,10204,5998,4206,59031.40925127401,64593.15271757253,51100.04041844983,632,321,311,35532.59493670886,44719.6261682243,26050.16077170418
56,"NYC-Brooklyn Community District 15--Sheepshead Bay, Gerritsen Beach & Homecrest PUMA",10579,6220,4359,77388.03799981094,87403.33826366559,63096.87772424868,5360,3168,2192,90509.07910447761,104986.92045454546,69584.89963503649,5068,2901,2167,64835.12036306235,71035.91864874182,56534.0055376096,151,151,0,32947.01986754967,32947.01986754967,0.0
57,"NYC-Queens Community District 12--Jamaica, Hollis & St. Albans PUMA",550,338,212,50101.818181818184,33715.976331360944,76226.41509433962,398,186,212,60834.17085427135,43290.32258064516,76226.41509433962,152,152,0,22000.0,22000.0,0.0,0,0,0,#DIV/0!,0.0,0.0
58,Suffolk County (North Central)--Brookhaven Town (North) PUMA,26397,15947,10450,99839.82422244952,116780.25647457202,73988.23827751196,14180,7969,6211,125528.70310296192,155849.0726565441,86626.26791176944,11882,7643,4239,71256.76064635583,80011.97043045925,55470.94597782496,335,335,0,26274.626865671642,26274.626865671642,0.0
59,Albany County (East Central)--Albany City PUMA,20257,10667,9590,63131.18270227576,65584.33561451205,60402.529718456724,10143,4647,5496,74659.94459232969,90253.58898213902,61475.14374090247,9791,5827,3964,51901.45541824124,47025.103827012186,59069.59384460141,323,193,130,41502.78637770898,31939.896373056996,55700.0
60,NYC-Manhattan Community District 3--Chinatown & Lower East Side PUMA,26536,15030,11506,92966.18759421163,102946.34051896208,79929.36346254128,23849,13299,10550,98052.75332299048,110620.3998796902,82210.37118483412,2542,1586,956,48418.819826907944,44598.23455233291,54757.15481171548,145,145,0,37310.34482758621,37310.34482758621,0.0
61,Rensselaer County--Troy City PUMA,49039,25859,23180,64072.546993209486,63495.59186356781,64716.18300258844,15342,7131,8211,77592.59744492243,86512.89300238396,69845.59615150408,31007,16776,14231,56946.50569226304,56612.2299713877,57340.56159089312,2690,1952,738,69103.23420074349,38566.75204918033,149871.8157181572
62,Warren & Washington Counties PUMA,38174,21296,16878,55010.08173102111,63698.27601427498,44047.6581348501,10482,4398,6084,90223.13585193665,133767.50159163255,58745.798487836946,26265,15902,10363,42287.3995811917,46064.596528738526,36491.2994306668,1427,996,431,30523.756131744918,35833.132530120485,18254.29234338747
63,Orange County (Northeast)--Greater Newburgh City PUMA,23584,14075,9509,72757.23838195387,80899.66536412078,60705.0078872647,8375,4755,3620,97803.38626865672,110418.31756046267,81233.22099447514,14447,8784,5663,61106.82840728179,69081.93192167577,48736.475366413564,762,536,226,18363.517060367452,12701.492537313432,31792.035398230088
64,"Rockland County (South)--Orangetown, Clarkstown (South) & Ramapo (Southeast) Towns PUMA",23084,13421,9663,103529.87060301508,107217.89233291111,98407.55458967194,13526,7179,6347,110921.13285524175,124158.9738125087,95948.0022057665,9147,5952,3195,95969.47523778288,90189.8622311828,106736.37871674492,411,290,121,28543.795620437955,37324.137931034486,7500.0
65,Fulton & Montgomery Counties PUMA,28787,16220,12567,42963.020877479416,44840.59938347719,40539.6641998886,6908,2928,3980,56954.978575564564,58391.45901639344,55898.19095477387,19780,11456,8324,39018.401921132456,43027.446752793294,33500.908217203265,2099,1836,263,34086.469747498806,34543.51851851852,30895.817490494297
66,NYC-Brooklyn Community District 11--Bensonhurst & Bath Beach PUMA,10887,6104,4783,61559.64728575365,71349.35779816513,49066.1509512858,3544,1655,1889,68648.27313769751,76336.90634441088,61912.06987824246,6581,3726,2855,61403.66205743808,77044.55179817499,40991.06830122592,762,723,39,29938.188976377955,30582.157676348546,18000.0
67,Monroe County (Central)--Rochester City (East) PUMA,18025,10697,7328,49869.634729542304,51175.66383098065,47963.16730349345,12409,7187,5222,55982.49061165283,59143.33324057326,51632.246265798545,4974,3192,1782,36660.120627261764,35023.47744360902,39591.75084175084,642,318,324,34059.19003115265,33232.70440251572,34870.37037037037
68,Chautauqua County PUMA,37367,21186,16181,44415.85693258758,50042.50920419145,37048.80575984179,9573,4047,5526,62404.80727044814,81276.04546577712,48584.34020991676,26623,16060,10563,38790.38447958532,43816.63412204234,31148.46748082931,1171,1079,92,25251.665243381725,25561.909175162185,21613.043478260868
69,Nassau County (Northwest)--North Hempstead Town (North) PUMA,19694,13178,6516,164480.9214481568,192496.7421460009,107821.54680785758,16767,11387,5380,178903.8727858293,208668.85641521032,115905.0124535316,2828,1692,1136,84096.19236209335,93869.85815602836,69538.93661971831,99,99,0,18000.0,18000.0,0.0
70,"Clinton, Franklin, Essex & Hamilton Counties PUMA",51945,28764,23181,48296.66735970738,52438.843763037126,43156.873473965745,15563,6508,9055,61015.89500738932,73101.84234787953,52329.49574820541,33999,20270,13729,43767.94952792729,47863.61677355698,37720.95593269721,2383,1986,397,29842.004196391103,31424.26988922457,21926.69017632242
71,NYC-Queens Community District 6--Forest Hills & Rego Park PUMA,11828,5972,5856,97948.35559688874,112721.03650368386,82883.04644808744,8979,3773,5206,101513.65965029513,127097.80811025709,82971.78640030733,2704,2054,650,88894.97041420119,91022.3953261928,82172.30769230769,145,145,0,46000.0,46000.0,0.0
72,Monroe County (Central)--Rochester City (West) PUMA,10734,5559,5175,46451.8222470654,52223.241590214064,40252.14685990338,3800,2082,1718,72315.78947368421,82804.99519692603,59604.19091967404,6822,3365,3457,32068.87423043096,33542.050520059434,30634.903095169222,112,112,0,45000.0,45000.0,0.0
73,Orange County (Southeast) PUMA,28187,16448,11739,79857.46358250258,85520.03100680934,71923.40540080075,11443,5519,5924,102738.72638294153,116706.1224859576,89726.22484807562,15313,9555,5758,66054.76915039509,73574.147566719,53576.88433483848,1431,1374,57,44588.67924528302,43327.07423580786,75000.0
74,Rockland County (North)--New City & Congers PUMA,18799,10969,7830,92818.1044204479,109011.38107393564,70133.04035759898,10352,5386,4966,106916.276564915,132793.33067211288,78850.66774063633,8117,5440,2677,77087.87113465567,86710.6544117647,57533.167725065374,330,143,187,37478.78787878788,61643.356643356645,19000.0
75,Westchester County (Southeast) PUMA,19734,12076,7658,149307.5930373974,172327.11170917522,113007.81405066597,14836,9399,5437,177469.67181180912,204114.51122459836,131408.45319109803,4797,2576,2221,64859.82697519283,62184.20419254658,67963.1157136425,101,101,0,23400.0,23400.0,0.0
76,"NYC-Manhattan Community District 9--Hamilton Heights, Manhattanville & West Harlem PUMA",9279,4915,4364,142403.5305528613,143461.03153611394,141212.50916590285,8491,4349,4142,144896.30785537628,147219.8091515291,142456.68759053596,788,566,222,115542.90609137056,114579.54063604241,117999.05405405405,0,0,0,#DIV/0!,0.0,0.0
77,Nassau County (Southwest)--Hempstead Town (Southwest) & Long Beach City PUMA,27212,14868,12344,104321.2615757754,133868.1349206349,68732.8856124433,17404,10069,7335,129388.02171914502,162499.11510577018,83935.31561008861,9634,4699,4935,55214.55677807764,72909.52117471803,38365.79533941236,174,100,74,316000.0,115460.0,587000.0
78,NYC-Queens Community District 2--Sunnyside & Woodside PUMA,14008,8266,5742,73572.52784123358,81386.67674812485,62323.528387321494,9518,5198,4320,85123.56272326119,97605.28472489418,70105.04629629629,3826,2404,1422,50557.73653946681,57581.53078202995,38683.47398030942,664,664,0,40608.43373493976,40608.43373493976,0.0
79,"NYC-Bronx Community District 11--Pelham Parkway, Morris Park & Laconia PUMA",5403,3525,1878,65407.12567092356,60719.51773049645,74205.75079872205,2333,1315,1018,85365.83797685384,70529.27756653992,104530.94302554027,2537,1907,630,55962.31769806858,59247.14210802307,46019.206349206346,533,303,230,23001.500938086305,27412.54125412541,17190.434782608696
80,Onondaga County (Central)--Syracuse City (Outer) PUMA,51541,28475,23066,64702.04058904562,75350.10774363477,51556.99106910604,22810,12600,10210,85733.8233231039,104966.49222222222,61999.08991185113,27289,15068,12221,49080.08223093554,53000.59835412796,44246.2440062188,1442,807,635,27651.17891816921,30239.776951672862,24361.417322834644
81,Wayne & Seneca Counties PUMA,38650,22302,16348,48142.94582147477,54754.467760738946,39123.48397357475,10556,5041,5515,65086.25862068965,83302.04522912121,48436.071804170446,27079,16405,10674,42101.905535654936,46840.01950624809,34819.84073449503,1015,856,159,33100.30541871921,38315.43224299065,5023.899371069182
82,"NYC-Bronx Community District 7--Bedford Park, Fordham North & Norwood PUMA",1239,687,552,63523.97094430993,47281.22270742358,83739.13043478261,946,394,552,65698.94291754757,40424.3654822335,83739.13043478261,293,293,0,56501.70648464164,56501.70648464164,0.0,0,0,0,#DIV/0!,0.0,0.0
83,Nassau County (West Central)--Hempstead Town (Northwest) PUMA,19229,11553,7676,94750.64267512612,106914.25257508871,76443.42730588849,10774,6052,4722,109655.41878596622,129165.64606741573,84649.9347734011,8290,5400,2890,76246.45307599517,82648.21111111112,64284.690657439445,165,101,64,51209.27272727273,70985.44554455446,20000.0
84,NYC-Brooklyn Community District 18--Canarsie & Flatlands PUMA,11492,6746,4746,77967.74147232858,92928.18766676549,56702.85103244838,5527,3279,2248,90802.31318979555,109435.79566941141,63622.95862989324,5638,3140,2498,62679.01738205037,72387.57324840764,50475.30824659728,327,327,0,124637.92048929664,124637.92048929664,0.0
85,"NYC-Bronx Community District 12--Wakefield, Williamsbridge & Woodlawn PUMA",2185,1627,558,58707.124942791765,60868.57283343577,52404.83870967742,772,461,311,78679.62176165803,78065.44034707158,79590.03215434084,1228,981,247,53488.925081433226,62380.2242609582,18175.708502024292,185,185,0,10000.0,10000.0,0.0
86,Suffolk County (South Central)--Brookhaven Town (South) PUMA,34373,18037,16336,66589.24475605853,69102.44885513112,63814.351126346715,8800,2922,5878,94948.51136363637,121947.1902806297,81527.25586934331,24529,14071,10458,57841.39630641282,60801.4767962476,53858.67565500096,1044,1044,0,33078.16091954023,33078.16091954023,0.0
87,NYC-Queens Community District 4--Elmhurst & South Corona PUMA,2369,1709,660,67701.62093710426,78043.6161497952,40922.121212121216,1181,1026,155,85540.90601185436,92420.86744639376,40000.0,1142,637,505,50368.94045534151,57633.79905808477,41205.148514851484,46,46,0,40000.0,40000.0,0.0
88,Livingston & Wyoming Counties PUMA,32291,18459,13832,47352.94983122232,51685.478574137276,41571.12883169462,7248,3467,3781,66484.3777593819,77631.5719642342,56262.92250727321,23213,13845,9368,43241.36505406453,47502.48197905381,36943.84543125534,1830,1147,683,23734.167213114753,23750.414995640804,23706.88140556369
89,"NYC-Bronx Community District 10--Co-op City, Pelham Bay & Schuylerville PUMA",11887,5692,6195,70039.70556069656,70206.6988756149,69886.27118644067,5804,2045,3759,66406.44383184011,68248.1173594132,65404.52247938282,6003,3567,2436,73473.09345327337,71199.64395850855,76802.07307060756,80,80,0,76000.0,76000.0,0.0
90,Cattaraugus & Allegany Counties PUMA,36721,21262,15459,44764.14898831731,47254.344981657414,41339.18312956853,8899,4344,4555,63447.59973030678,72578.19981583794,54739.95389681668,25007,14737,10270,39513.04654696685,41714.07905272443,36354.66134371957,2815,2181,634,32348.621669627,34251.16918844567,25803.738170347002
91,Herkimer (North & Central) & Oneida (Outer) Counties PUMA,37968,21158,16810,49007.0645280236,54012.129879950844,42707.41118381915,8489,3665,4824,68283.47143361998,82198.46930422919,57711.64987562189,27823,16255,11568,43988.237681055245,49125.533928022145,36769.46602697096,1656,1238,418,34515.157004830915,34729.9676898223,33878.94736842105
92,Orange County (Northwest) PUMA,25221,13578,11643,64695.77693192181,72816.90897039328,55224.95920295457,7683,3911,3772,91132.40531042562,96334.90411659422,85738.19194061506,16893,9245,7648,53592.062984668206,64763.84856679286,40087.4660041841,645,422,223,40606.51162790698,31280.568720379146,58254.708520179374
93,Columbia & Greene Counties PUMA,31609,17453,14156,57645.37619032554,65603.8985274738,47833.27599604408,9944,4853,5091,80527.34865245374,103526.9534308675,58602.95619721076,20510,11633,8877,47964.90692345198,52434.8264420184,42107.23273628478,1155,967,188,32544.155844155845,33706.51499482937,26565.425531914894
94,Suffolk County (East) PUMA,33590,19336,14254,85897.03069365883,98829.90934009102,68353.17342500351,14931,7977,6954,116859.6960016074,145702.04675943337,83774.35921771642,18411,11111,7300,61684.04975286513,66953.9915399154,53662.9095890411,248,248,0,19290.725806451614,19290.725806451614,0.0
95,Monroe County (East) PUMA,41881,21382,20499,67100.06107781571,76999.39425685156,56774.311429825844,24085,11290,12795,78424.05721403363,92600.59592559788,65915.02071121531,17402,9698,7704,52008.87484197219,60282.998556403385,41593.18795430945,394,394,0,41410.659898477155,41410.659898477155,0.0
96,Sullivan & Ulster (West) Counties PUMA,27165,15196,11969,52161.8644579422,53098.197420373785,50973.083799816195,7318,3187,4131,77309.35884121344,79763.54188892375,75415.9961268458,18355,10707,7648,42705.72378098611,45959.391052582425,38150.67468619247,1492,1302,190,45149.86595174263,46533.48694316436,35668.42105263158
97,Cayuga & Onondaga (South) Counties PUMA,37696,21132,16564,54651.468909168085,61910.19581677077,45390.939024390245,11788,5877,5911,73200.83389888021,90016.67857750553,56481.71375401793,24479,13895,10584,45843.47530536378,50807.6882331774,39326.304232804236,1429,1360,69,52517.78166550035,53886.330882352944,25543.478260869564
98,"NYC-Bronx Community District 1 & 2--Hunts Point, Longwood & Melrose PUMA",248,35,213,22798.387096774193,35500.0,20711.267605633802,83,0,83,17900.0,0.0,17900.0,165,35,130,25262.424242424244,35500.0,22506.153846153848,0,0,0,#DIV/0!,0.0,0.0
99,Suffolk County (Southwest)--Babylon Town (Southeast) PUMA,25824,15362,10462,73136.50495662949,83316.58833485223,58188.46052380042,9654,5100,4554,86141.97431116636,97214.36862745098,73742.05972771191,15661,9884,5777,66439.08971330055,77919.54168352894,46796.92470140211,509,378,131,32534.18467583497,36929.62962962963,19851.14503816794
100,Onondaga County (Central)--Syracuse City PUMA,18327,9743,8584,47693.92033611611,50151.882479729036,44904.08748835042,7888,4649,3239,60342.948022312376,61721.974833297485,58363.60389008954,10054,4884,5170,38129.033618460315,39135.81695331696,37177.94468085106,385,210,175,38316.88311688312,50214.28571428572,24040.0
101,Ulster County (East) PUMA,38816,19226,19590,61345.69643961253,68580.19556850099,54245.620877998976,15672,6027,9645,76419.9806661562,85226.27177700348,70917.07589424572,21823,12224,9599,51459.06685606929,62016.500327225134,38014.53443066986,1321,975,346,45836.033308099926,47973.743589743586,39812.1387283237
102,NYC-Queens Community District 9--Richmond Hill & Woodhaven PUMA,7241,4384,2857,78626.49495925977,87281.82025547445,65345.09975498775,4018,2298,1720,85641.90642110503,97571.07919930374,69703.97674418605,3024,1945,1079,71710.27447089947,78080.80205655527,60226.79332715477,199,141,58,42077.38693467337,46510.63829787234,31300.0
103,NYC-Brooklyn Community District 13--Brighton Beach & Coney Island PUMA,5791,3208,2583,49563.192885512,46116.69264339152,53843.63143631436,2765,1214,1551,57932.40506329114,66300.65897858319,51382.39845261122,2838,1806,1032,42821.8992248062,34410.049833887046,57542.635658914725,188,188,0,28238.297872340427,28238.297872340427,0.0
104,Broome County (West Central)--Greater Binghamton City & Greater Johnson City Village PUMA,26887,15047,11840,51133.054301335214,60098.65428324583,39739.01858108108,9864,5678,4186,65335.48154906731,76640.9316660796,50000.47300525561,16107,8895,7212,44270.01241696157,51874.31028667791,34891.167498613424,916,474,442,18873.52729257642,16276.900843881856,21658.14479638009
105,Nassau County (South Central)--Hempstead Town (Southeast) PUMA,25677,14045,11632,96600.9526034973,112399.93065147739,77524.55588033012,14089,6588,7501,115458.71176094825,144342.70734669096,90090.39248100253,11022,7094,3928,75397.5476320087,87010.8218212574,54423.87983706721,566,363,203,40093.81625441696,28849.86225895317,60200.0
106,Saratoga County (Outer) PUMA,38977,21609,17368,60717.28963234728,64614.61557684298,55868.29629203132,14527,7837,6690,80837.70854271356,91244.26719407937,68646.94618834081,23252,12798,10454,46448.753053500775,50502.41490857946,41486.177539697725,1198,974,224,93674.45742904842,35776.18069815195,345428.5714285714
107,"NYC-Manhattan Community District 4 & 5--Chelsea, Clinton & Midtown Business District PUMA",42421,25786,16635,130631.93333490488,144492.7511052509,109146.20763450555,36947,21757,15190,136917.78071291308,154438.05120191202,111823.07860434496,5474,4029,1445,88205.33430763609,90787.14321171507,81006.64359861592,0,0,0,#DIV/0!,0.0,0.0
108,NYC-Brooklyn Community District 4--Bushwick PUMA,10496,5544,4952,58222.337652439026,61278.81493506493,54800.465670436184,8993,4355,4638,60416.21883687312,66969.26521239954,54263.0241483398,1420,1106,314,45744.08450704225,40919.168173598555,62738.85350318471,83,83,0,34000.0,34000.0,0.0
109,Suffolk County (Central)--Islip Town (East) PUMA,29884,17678,12206,80186.81585463793,88079.55826450956,68755.72456169098,13483,6383,7100,95727.83905658979,107331.07002976656,85296.37098591549,15227,10317,4910,69313.4176134498,80933.39245904818,44897.270875763745,1174,978,196,42733.3398637138,37818.40593047035,67257.85714285714
110,Westchester County (Southwest)--Yonkers City PUMA,22695,12003,10692,72767.28446794448,78478.67599766725,66355.59044145155,13656,6506,7150,86098.71272700644,97342.23762680602,75867.89132867134,8938,5435,3503,52843.309465204744,56530.809567617296,47122.05252640594,101,62,39,33425.74257425743,23000.0,50000.0
111,Nassau County (West Central)--North Hempstead Town (South) PUMA,17300,9663,7637,89125.0460115607,108957.48628790231,64031.30889092576,9499,5566,3933,112413.8025055269,137731.7786561265,76583.68421052632,7613,3996,3617,60941.322212005776,70191.21871871872,50722.19408349461,188,101,87,53714.36170212766,57000.0,49900.0
112,"NYC-Queens Community District 8--Briarwood, Fresh Meadows & Hillcrest PUMA",12021,6852,5169,72010.9957574245,76875.18096906012,65563.05668407815,6416,3488,2928,89757.73690773068,102931.39334862385,74064.52868852459,5605,3364,2241,51696.43889384478,49858.513674197384,54455.377063810796,0,0,0,#DIV/0!,0.0,0.0
113,Jefferson & Lewis Counties PUMA,41684,25542,16142,50599.114576336244,57567.52094589304,39572.78354602899,10740,6681,4059,81746.541433892,95787.59976051489,58635.353781719634,28422,16942,11480,40572.78119062698,45066.793530870025,33940.58980836237,2522,1919,603,30950.059476605868,34867.6654507556,18482.587064676616
114,Suffolk County (Central)--Brookhaven Town (West Central) PUMA,27718,16001,11717,74159.30052673352,85982.66370851822,58013.04856191858,10905,5480,5425,83553.75809261807,102066.83065693431,64852.995391705066,16376,10231,6145,68298.83732291158,78061.80920731112,52044.16436126932,437,290,147,59340.96109839817,61489.65517241379,55102.04081632653
115,Suffolk County (Northwest)--Huntington Town (South) PUMA,22800,14499,8301,111902.17057017544,131906.73349886198,76961.06011323936,14045,8932,5113,135543.1090779637,162667.77955665023,88158.49012321534,8489,5374,3115,75354.75580162564,84439.36025307034,59681.99036918138,266,193,73,30000.0,30000.0,30000.0
116,NYC-Brooklyn Community District 16--Brownsville & Ocean Hill PUMA,562,269,293,28616.97508896797,32277.695167286245,25256.109215017066,141,141,0,28449.64539007092,28449.64539007092,0.0,339,128,211,24481.828908554573,36494.53125,17194.502369668247,82,0,82,46000.0,0.0,46000.0
117,"NYC-Staten Island Community District 1--Port Richmond, Stapleton & Mariner's Harbor PUMA",18231,10240,7991,73690.20788766387,83526.363671875,61085.748467025405,8527,3897,4630,91444.52210625073,118683.57813702848,68517.82634989201,9405,6044,3361,59100.58904837852,63690.0,50847.56917584052,299,299,0,26279.933110367892,26279.933110367892,0.0
118,Chemung (South) & Steuben (East) Counties--Greater Elmira & Greater Corning Cities PUMA,30309,16803,13506,57186.76703289452,64991.57114800929,47476.70309492078,10862,4758,6104,77381.06260357209,106384.47246742329,54773.22771952818,18657,11454,7203,45991.53561665863,48330.40946394273,42272.32680827433,790,591,199,43919.670886075946,54652.35194585448,12045.226130653265
119,Monroe County (Central)--Greece & Gates Towns PUMA,37383,21101,16282,51266.27129978868,57072.03829202407,43742.16558162388,12446,6307,6139,61692.70287642616,69368.50959251625,53806.83987620134,23768,13742,10026,46494.78458431504,52865.25178285548,37763.19070416916,1169,1052,117,37272.54063301968,38303.80228136882,28000.0
120,NYC-Queens Community District 3--Jackson Heights & North Corona PUMA,3747,2198,1549,64024.92714171337,72315.08189262966,52261.36346029697,2414,1272,1142,71827.00994200497,84597.13050314465,57603.197898423816,1237,926,311,52215.84478577203,55443.84449244061,42604.501607717044,96,0,96,20000.0,0.0,20000.0
121,"NYC-Queens Community District 14--Far Rockaway, Breezy Point & Broad Channel PUMA",9200,5469,3731,87928.98695652174,104571.6182117389,63533.77110694184,5222,3140,2082,115490.23362696284,137979.6178343949,81572.52641690683,3206,1981,1225,58552.42669993762,65947.5921251893,46593.38775510204,772,348,424,23494.300518134714,23000.0,23900.0
122,NYC-Brooklyn Community District 10--Bay Ridge & Dyker Heights PUMA,17927,10242,7685,84222.2300440676,88487.76899043156,78537.4350032531,10582,5373,5209,101122.11661311661,113767.5842173832,88078.51948550585,7199,4766,2433,60509.73468537297,61432.10239194293,58702.90998766955,146,103,43,28548.630136986303,21680.582524271846,45000.0
123,Broome (Outer West) & Tioga Counties PUMA,36067,20983,15084,58958.66747996784,65251.229090215886,50205.23203394325,12139,6772,5367,93110.86415684983,107478.65623154164,74981.7998882057,22032,12691,9341,42187.85993100944,45908.03955559058,37133.4974842094,1896,1520,376,35182.77953586498,38619.83552631579,21288.297872340427
124,Putnam County PUMA,29528,16743,12785,94535.05872392305,104545.1218419638,81426.06484161127,15450,8129,7321,118813.28388349514,130137.12584573748,106239.6585165961,13793,8429,5364,68132.09439570797,80452.51856685254,48771.755965697244,285,185,100,56210.52631578947,77729.72972972973,16400.0
125,"NYC-Brooklyn Community District 17--East Flatbush, Farragut & Rugby PUMA",783,225,558,72911.87739463602,40111.11111111111,86137.99283154123,538,50,488,89005.57620817843,65000.0,91465.16393442624,245,175,70,37571.42857142857,33000.0,49000.0,0,0,0,#DIV/0!,0.0,0.0
126,"NYC-Queens Community District 11--Bayside, Douglaston & Little Neck PUMA",15920,9513,6407,76577.4501884422,79587.86229370335,72107.64367098486,8266,4456,3810,92017.41761432374,98296.57854578097,84673.60104986877,7654,5057,2597,59902.93088581134,63102.58651374333,53672.41162880247,0,0,0,#DIV/0!,0.0,0.0
127,Nassau County (Central)--Hempstead Town (Northeast) PUMA,29038,17589,11449,76883.20049590193,84794.43345272614,64729.241505808364,13660,8399,5261,87719.83572474378,90810.14644600547,82786.26420832542,14933,8810,6123,66796.31152481082,79010.53007945516,49222.039849746856,445,380,65,82723.82022471911,85926.57894736843,64000.0
128,Suffolk County (Central)--Brookhaven Town (Central) PUMA,30959,18429,12530,71074.83510449305,78931.950729828,59518.667198723066,11719,6122,5597,90711.33458486218,109820.68441685724,69809.52295872789,18165,11323,6842,59986.46242774567,65107.45297182725,51511.604793919905,1075,984,91,44377.3023255814,45836.382113821135,28600.0
129,NYC-Manhattan Community District 10--Central Harlem PUMA,9643,5303,4340,109293.12662034636,118618.57439185366,97898.46082949308,8431,4774,3657,116740.63812121931,123047.63301214915,108507.22450095706,1212,529,683,57486.22112211221,78648.20415879018,41095.75402635432,0,0,0,#DIV/0!,0.0,0.0
130,"NYC-Bronx Community District 5--Morris Heights, Fordham South & Mount Hope PUMA",237,124,113,29008.86075949367,30778.225806451614,27067.256637168142,119,53,66,41159.663865546216,70000.0,18000.0,118,71,47,16755.084745762713,1500.0,39800.0,0,0,0,#DIV/0!,0.0,0.0
131,NYC-Manhattan Community District 11--East Harlem PUMA,4608,2966,1642,109419.16232638889,123534.96291301415,83921.31546894032,3898,2487,1411,119477.03950743971,138512.14314435062,85926.15166548546,710,479,231,54200.0,45772.44258872652,71675.32467532468,0,0,0,#DIV/0!,0.0,0.0
132,Westchester County (Northwest) PUMA,25594,14982,10612,121597.56208486365,148300.99866506475,83897.70467395401,17815,9788,8027,141167.36087566658,182148.47691050265,91195.62003239068,7644,5059,2585,77490.5808477237,85796.16525004942,61236.05415860735,135,135,0,36544.22222222222,36544.22222222222,0.0
133,Onondaga County (North) PUMA,45142,24628,20514,61159.95547383811,65849.8160630177,55529.56225017062,20981,11140,9841,75403.32634288166,84407.5,65210.61274260746,23518,12958,10560,49091.714006293056,51111.21546534959,46613.617424242424,643,530,113,37801.85069984448,36133.188679245286,45628.318584070796
134,NYC-Brooklyn Community District 8--Crown Heights North & Prospect Heights PUMA,9516,5814,3702,76727.89533417403,78230.81527347781,74367.55591572123,7636,4675,2961,80867.20429544264,78329.08663101605,84874.53292806484,1880,1139,741,59915.255319148935,77827.46268656716,32382.186234817815,0,0,0,#DIV/0!,0.0,0.0
135,NYC-Brooklyn Community District 3--Bedford-Stuyvesant PUMA,7829,3873,3956,60988.674160173716,55363.49083397883,66495.83670374115,6008,2417,3591,64080.530958721705,55308.35746793546,69984.83152325258,1391,1159,232,46001.725377426315,51964.10698878343,16215.51724137931,430,297,133,66270.0,69077.77777777778,60000.0
136,Genesee & Orleans Counties PUMA,32631,19421,13210,47921.52781097729,52217.64821584882,41605.48281604845,6666,3263,3403,67400.28712871287,72465.15783021759,62543.786071113725,24088,14731,9357,43067.872550647626,48266.47450953771,34883.560756652776,1877,1427,450,41032.576451784764,46707.56832515767,23036.546666666665
137,Westchester County (Central)--White Plains City PUMA,33174,20150,13024,142160.91731476458,171360.42838709676,96985.07670454546,24136,14262,9874,165239.36476632417,203243.3277240219,110346.46222402269,8174,5024,3150,86492.04343038904,106173.02786624203,55102.43523809524,864,864,0,24123.84259259259,24123.84259259259,0.0
138,Saratoga County (South & Central) PUMA,37350,21092,16258,70865.31949129853,78980.41911625261,60337.352872432035,20786,11025,9761,79330.02314057539,94518.81342403629,62174.36154082573,15902,9789,6113,61708.6669601308,63416.94575543978,58973.12939636839,662,278,384,25037.16012084592,10779.136690647481,35359.375
139,Monroe County (South) PUMA,53099,31123,21976,85486.7650991544,101850.48317964206,62312.02912267928,33406,19714,13692,105408.68263186254,128800.45754286295,71728.76365761028,19693,11409,8284,51692.4434062865,55282.7038303094,46747.817479478515,0,0,0,#DIV/0!,0.0,0.0
140,Suffolk County (Central)--Islip Town (Northwest) PUMA,8310,4625,3685,53252.42478941035,57854.34594594595,47476.6078697422,3215,1292,1923,71503.53032659409,91160.48761609907,58296.671866874676,4292,2589,1703,44078.54147250699,49595.71263035921,35691.01585437464,803,744,59,29213.823163138233,28754.97311827957,35000.0
141,St. Lawrence County PUMA,28875,16451,12424,45352.44003463203,51743.64537110206,36889.648744365746,8552,4755,3797,62238.11389148737,73209.87592008412,48498.12746905452,19223,10959,8264,38792.25178171982,43698.27082763026,32286.31485963214,1100,737,363,28716.272727272728,32879.7829036635,20263.085399449035
142,Nassau County (West Central)--Hempstead Town (West Central) PUMA,17654,10029,7625,94729.94301574714,111533.86578921128,72628.10150819672,9058,5194,3864,126088.40516670347,153328.8602233346,89471.70652173914,8350,4589,3761,62822.87904191617,68969.37023316626,55323.21191172561,246,246,0,23100.0,23100.0,0.0
143,Nassau County (Central)--Hempstead Town (North Central)--Meadowbrook Corridor PUMA,5112,3007,2105,84558.57961658842,87183.46491519787,80808.9216152019,2557,1512,1045,96037.09777082519,115487.88293650794,67893.95215311005,2274,1358,916,76782.14599824099,59800.44182621502,101958.07860262008,281,137,144,43039.14590747331,46233.57664233576,40000.0
144,"NYC-Bronx Community District 9--Castle Hill, Clason Point & Parkchester PUMA",1211,673,538,92356.8455821635,121000.59435364042,56525.53903345725,772,542,230,122678.67875647669,135063.46863468635,93493.65217391304,439,131,308,39034.62414578588,62816.79389312977,28919.48051948052,0,0,0,#DIV/0!,0.0,0.0
145,Nassau County (Southeast)--Oyster Bay Town (South) PUMA,34113,20690,13423,82898.27499780142,93082.33296278396,67200.72904715786,17339,10224,7115,95975.87259934252,111941.54626369326,73033.77174982431,16440,10132,6308,67592.09245742092,71931.88906435057,60621.44895370957,334,334,0,157392.8143712575,157392.8143712575,0.0
146,Capital Region,319794,172683,147111,63180.11536801816,69018.95062050116,56326.327494205056,125652,61503,64149,83825.41501130105,100591.57302895794,67750.82278757269,184649,104447,80202,49750.910467968955,52543.44915603129,46114.1895838009,9493,6733,2760,51125.555672600865,36196.390910441114,87545.14492753622
147,Central NY,228176,127063,101113,56022.75116138419,62237.70729480651,48212.76657798701,86089,45196,40893,74953.05421133943,87162.27526772281,61459.10769569364,134662,76132,58530,44868.83044214403,48927.05286870173,39590.15984964975,7425,5735,1690,38826.57777777778,42512.50566695728,26318.414201183434
148,Finger Lakes,340982,193820,147162,58045.469752069024,65469.14523269013,48268.10343702858,136680,70225,66455,79189.36196956395,95841.09439658241,61592.97479497404,192250,114469,77781,44486.1122236671,49043.617250085175,37778.90811380671,12052,9126,2926,34550.55575838035,37783.81021257945,24466.24948735475
149,Long Island,615605,360646,254959,93304.54423697013,107922.9347670569,72626.45846194879,315567,174218,141349,118552.03019960895,143161.22374840718,88220.2663973569,288506,177305,111201,67104.5445502,75886.3939652012,53102.280087409286,11532,9123,2409,57888.63258758238,57620.910994190504,58902.507264425076
150,Mid-Hudson,461938,261431,200507,94312.59461659357,109606.90299161155,74371.11460447765,241574,127932,113642,124617.9542790201,153210.8588937873,92429.61305679238,208891,124642,84249,62212.51420597345,69804.67912902554,50980.302306258825,11473,8857,2616,40658.880850692934,39909.20627752061,43197.05657492355
151,Mohawk Valley,135893,75547,60346,50090.18473357715,56284.47993964022,42335.562721638555,39028,18642,20386,71354.0074561853,87507.06265422165,56582.828460708326,91137,52302,38835,42021.01595400331,47015.99181675653,35293.90825286468,5728,4603,1125,33594.96159217877,35148.06430588746,27240.355555555554
152,New York City,820341,451792,368549,107209.13029703501,122023.86652707441,89048.23632949757,600098,311974,288124,122125.35930131412,143851.06485796894,98601.26805819717,207277,129805,77472,67895.46636143904,75165.02051538847,55715.266070322185,12966,10013,2953,45325.67561314206,49417.66803155898,31450.59261767694
153,North Country,122504,70757,51747,48386.13909749886,54128.57006373928,40534.14404699789,34855,17944,16911,67703.58855257495,81576.94516272849,52982.78487375081,81644,48171,33473,41484.12080495811,45932.33435054286,35082.69593403639,6005,4642,1363,30101.15670274771,33078.85609651013,19959.93837123991
154,Southern Tier,185868,102582,83286,52995.50548776551,59868.853229611435,44529.715822587226,61211,29965,31246,74913.41727794024,91356.3941264809,59144.557223324584,115765,65795,49970,42739.58612706776,47686.08117638119,36226.585491294776,8892,6822,2070,35638.241228070176,39059.90046907066,24361.642512077295
155,Western NY,388833,219371,169462,57520.94835314904,64169.94721271271,48913.723554543205,145086,74946,70140,76151.70886232994,87989.00312224802,63503.321984602226,232146,135499,96647,47091.74273517528,52829.74385050812,39047.070752325475,11601,8926,2675,33215.78915610723,36323.571588617524,22845.671028037385
