,puma,Total_geo,Total_geo_m,Total_geo_f,Total_Avg_PINCP_mf_t,Total_Avg_PINCP_m,Total_Avg_PINCP_f,Total_BABS,Total_BABS_m,Total_BABS_f,BABS_Avg_PINCP_mf_t,BABS_Avg_PINCP_m,BABS_Avg_PINCP_f,Total_HS,Total_HS_m,Total_HS_f,HS_Avg_PINCP_mf_t,HS_Avg_PINCP_m,HS_Avg_PINCP_f,Total_HSINC,Total_HSINC_m,Total_HSINC_f,HSINC_Avg_PINCP_mf_t,HSINC_Avg_PINCP_m,HSINC_Avg_PINCP_f
0,Total Geo,531136,283571,247565,54794.323188411254,58356.95694552687,50713.5378708622,177408,78427,98981,77027.43496911075,88685.33446389636,67790.36842424303,302034,169162,132872,45605.69838826093,49811.00507797259,40251.83835571076,51694,35982,15712,32179.420261539057,32429.73350564171,31606.178716904276
1,Nassau County (Central)--Hempstead Town (Northeast) PUMA,3272,1552,1720,73226.77200488998,92337.94974226804,55982.267441860466,1179,324,855,99790.92451229856,177391.97530864197,70384.21052631579,1774,1008,766,58359.91995490417,69437.99404761905,43781.984334203655,319,220,99,57724.137931034486,72000.0,26000.0
2,"Chenango, Delaware & Broome (East) Counties PUMA",427,137,290,56965.105386416864,113000.0,30493.44827586207,137,137,0,113000.0,113000.0,0.0,290,0,290,30493.44827586207,0.0,30493.44827586207,0,0,0,#DIV/0!,0.0,0.0
3,Cayuga & Onondaga (South) Counties PUMA,745,313,432,68657.71812080537,52727.15654952077,80200.0,432,0,432,80200.0,0.0,80200.0,205,205,0,55132.68292682927,55132.68292682927,0.0,108,108,0,48161.11111111111,48161.11111111111,0.0
4,NYC-Brooklyn Community District 5--East New York & Starrett City PUMA,7271,3801,3470,49447.76509420988,50553.48592475664,48236.57060518732,1217,272,945,70876.41741988497,90417.64705882352,65251.851851851854,5464,3188,2276,45776.92166910688,46793.350062735255,44353.20738137083,590,341,249,39242.372881355936,53909.09090909091,19156.626506024095
5,"NYC-Staten Island Community District 1--Port Richmond, Stapleton & Mariner's Harbor PUMA",8868,4463,4405,62660.82949932341,70357.10284561953,54863.22043132804,3081,1154,1927,83189.93638429082,102937.17504332756,71364.13803840167,5057,2796,2261,54487.05596203283,63713.966380543636,43076.86510393631,730,513,217,32639.72602739726,33274.85380116959,31138.24884792627
6,"NYC-Queens Community District 5--Ridgewood, Glendale & Middle Village PUMA",15464,8784,6680,53734.24954733575,50116.90972222222,58490.94311377245,4711,2374,2337,59171.630227128,48741.1752316765,69767.22293538725,10195,5915,4280,52103.171652770965,51920.42857142857,52355.72429906542,558,495,63,37629.121863799286,35163.73737373737,57000.0
7,"Otsego, Schoharie, Oneida (South) & Herkimer (South) Counties PUMA",771,256,515,39762.619974059664,44030.9375,37640.8932038835,0,0,0,#DIV/0!,0.0,0.0,771,256,515,39762.619974059664,44030.9375,37640.8932038835,0,0,0,#DIV/0!,0.0,0.0
8,Erie County (Northwest) PUMA,1047,453,594,44347.27793696275,18642.384105960264,63950.50505050505,338,0,338,86111.2426035503,0.0,86111.2426035503,709,453,256,24437.235543018334,18642.384105960264,34691.40625,0,0,0,#DIV/0!,0.0,0.0
9,NYC-Manhattan Community District 7--Upper West Side & West Side PUMA,4918,3141,1777,73646.50264335096,78264.56542502387,65483.68036015757,2802,1722,1080,104945.96716630978,124296.51567944251,74092.5925925926,1740,1202,538,37180.747126436785,26231.28119800333,61644.05204460966,376,217,159,9150.0,1200.0,20000.0
10,"NYC-Manhattan Community District 6--Murray Hill, Gramercy & Stuyvesant Town PUMA",1846,1149,697,117509.31744312026,142830.2872062663,75767.86226685796,1660,963,697,125409.75903614458,161339.56386292833,75767.86226685796,186,186,0,47000.0,47000.0,0.0,0,0,0,#DIV/0!,0.0,0.0
11,Saratoga County (South & Central) PUMA,1382,960,422,48313.31403762663,44828.125,56241.70616113744,114,114,0,68500.0,68500.0,0.0,921,645,276,56916.39522258415,46511.62790697674,81231.88405797101,347,201,146,18847.26224783862,26000.0,9000.0
12,Nassau County (South Central)--Hempstead Town (Southeast) PUMA,4094,1603,2491,58954.46995603322,59516.281971303804,58592.934564431955,1129,604,525,66712.6660761736,57658.27814569537,77129.52380952382,2965,999,1966,56000.33726812816,60639.63963963964,53642.92980671414,0,0,0,#DIV/0!,0.0,0.0
13,Columbia & Greene Counties PUMA,1204,543,661,31680.581395348836,23696.13259668508,38239.6671709531,430,247,183,38309.3023255814,26983.805668016194,53595.62841530055,293,23,270,40800.06825938567,10000.0,43423.77777777778,481,273,208,20199.5841995842,21875.457875457876,18000.0
14,NYC-Staten Island Community District 2--New Springville & South Beach PUMA,4319,2517,1802,63286.22366288493,71953.03933253874,51180.577136514985,523,344,179,134374.76099426387,150517.44186046513,103351.95530726257,3706,2083,1623,54310.091743119265,61231.7810849736,45426.61737523106,90,90,0,19800.0,19800.0,0.0
15,Nassau County (Northeast)--Oyster Bay Town (North) & Glen Cove City PUMA,780,381,399,64297.4358974359,79640.41994750657,49646.61654135338,291,32,259,54192.43986254295,40468.75,55888.03088803089,470,330,140,71940.4255319149,86296.9696969697,38100.0,19,19,0,30000.0,30000.0,0.0
16,NYC-Brooklyn Community District 18--Canarsie & Flatlands PUMA,2769,1604,1165,57645.44131455399,64950.67144638404,47587.424892703864,614,332,282,102021.53094462541,129830.78313253012,69281.56028368794,1897,1065,832,47294.02055877702,52050.75774647887,41205.168269230766,258,207,51,28148.25581395349,27260.869565217392,31750.0
17,Putnam County PUMA,2996,691,2305,51643.00066755674,55174.819102749636,50584.221258134494,928,332,596,79568.96551724138,72469.8795180723,83523.4899328859,1935,305,1630,38638.05167958656,42895.08196721312,37841.490797546016,133,54,79,45998.496240601504,18200.0,65000.0
18,Nassau County (Northwest)--North Hempstead Town (North) PUMA,1239,891,348,130963.11541565778,98371.49270482604,214408.908045977,764,416,348,170825.0,134365.38461538462,214408.908045977,342,342,0,69859.64912280702,69859.64912280702,0.0,133,133,0,59105.26315789474,59105.26315789474,0.0
19,NYC-Queens Community District 3--Jackson Heights & North Corona PUMA,7506,4543,2963,51587.87370103917,55580.383006823686,45466.38542018225,2404,1614,790,61370.33277870216,61093.729863692686,61935.443037974685,4358,2252,2106,50012.23038090867,59669.80461811723,39685.13770180437,744,677,67,29208.333333333332,28833.08714918759,33000.0
20,Rockland County (North)--New City & Congers PUMA,3754,1907,1847,67283.80394246138,71805.97797587834,62614.726583649164,2095,841,1254,76249.64200477327,78575.50535077289,74689.79266347688,1507,1005,502,60597.478433974786,69892.53731343284,41988.84462151394,152,61,91,10000.0,10000.0,10000.0
21,"NYC-Bronx Community District 3 & 6--Belmont, Crotona Park East & East Tremont PUMA",10229,4936,5293,38822.72949457425,42122.447325769856,35745.56962025316,2037,718,1319,40623.71134020619,44225.626740947075,38663.002274450344,7410,3888,3522,39112.199730094464,41911.265432098764,36022.26007950029,782,330,452,31388.49104859335,40034.545454545456,25076.106194690266
22,Orange County (Northwest) PUMA,4401,1768,2633,66059.82731197456,76549.83031674208,59016.027345233575,2126,612,1514,86983.16086547507,146003.26797385621,63125.62747688243,1840,841,999,49729.40217391304,41670.749108204516,56513.51351351351,435,315,120,32875.862068965514,34733.333333333336,28000.0
23,NYC-Brooklyn Community District 2--Brooklyn Heights & Fort Greene PUMA,3296,1739,1557,88300.59162621359,128666.73375503163,43215.992292870906,1898,1172,726,100524.20969441517,130724.7866894198,51770.66115702479,1398,567,831,71705.15021459227,124412.69841269842,35742.238267148015,0,0,0,#DIV/0!,0.0,0.0
24,Dutchess County (Southwest) PUMA,6544,3305,3239,60010.632640586795,69276.49016641453,50555.967891324486,1930,1531,399,93357.40932642487,95005.74787720444,87032.58145363409,4114,1397,2717,48575.54205153136,54916.96492483894,45314.97239602503,500,377,123,25380.0,18000.0,48000.0
25,Westchester County (Northwest) PUMA,3923,1385,2538,75465.63650267653,61652.9963898917,83003.26713947991,1927,363,1564,120182.35184224183,136053.4435261708,116498.71611253197,1556,582,974,35355.5912596401,45627.147766323025,29217.967145790553,440,440,0,21470.454545454544,21470.454545454544,0.0
26,Nassau County (Southeast)--Oyster Bay Town (South) PUMA,1663,1205,458,91158.59891761876,75365.76763485477,132709.60698689957,830,451,379,108006.02409638555,76261.64079822616,145781.00263852242,833,754,79,74371.84873949579,74829.90716180371,70000.0,0,0,0,#DIV/0!,0.0,0.0
27,Westchester County (South Central)--New Rochelle & Mount Vernon Cities PUMA,5300,2533,2767,82376.16981132075,76867.31148835373,87419.15431875677,3166,1323,1843,108000.03158559697,97654.34618291761,115426.69560499187,2059,1135,924,43608.83924235065,53421.32158590308,31555.627705627707,75,75,0,65000.0,65000.0,0.0
28,Saratoga County (Outer) PUMA,781,520,261,69686.29961587708,69023.07692307692,71007.66283524904,302,165,137,117019.86754966888,127000.0,105000.0,330,206,124,43836.36363636364,50087.3786407767,33451.6129032258,149,149,0,31000.0,31000.0,0.0
29,NYC-Queens Community District 9--Richmond Hill & Woodhaven PUMA,7432,3925,3507,53687.960979547905,52103.24840764331,55461.55574565155,2141,962,1179,61702.24194301728,64964.65696465696,59040.28837998304,4850,2719,2131,52177.51051546392,48547.535858771604,56809.09244486157,441,244,197,31391.156462585033,41018.44262295082,19467.005076142133
30,Erie County (South) PUMA,842,91,751,34609.26365795724,43000.0,33592.54327563249,91,91,0,43000.0,43000.0,0.0,751,0,751,33592.54327563249,0.0,33592.54327563249,0,0,0,#DIV/0!,0.0,0.0
31,"NYC-Queens Community District 12--Jamaica, Hollis & St. Albans PUMA",3965,2243,1722,47969.51878940732,44748.68479714668,52164.83275261324,1764,906,858,55065.78344671202,48073.730684326714,62449.0,2074,1210,864,43646.62487945998,44856.61157024794,41952.083333333336,127,127,0,20000.0,20000.0,0.0
32,NYC-Brooklyn Community District 1--Greenpoint & Williamsburg PUMA,9079,4710,4369,59516.0039651944,66580.08492569003,51900.572213321124,3937,1890,2047,75401.82880365761,91019.04761904762,60982.413287738156,4314,2153,2161,49111.682892906814,54550.023223409196,43693.47524294308,828,667,161,38189.61352657005,36161.91904047976,46590.06211180124
33,Suffolk County (Central)--Brookhaven Town (Central) PUMA,4722,2733,1989,62053.64252435409,68827.69849981705,52745.70135746607,704,249,455,73257.10227272728,61445.78313253012,79720.87912087912,3903,2484,1419,61124.59646425826,69567.6731078905,46344.74982381959,115,0,115,25000.0,0.0,25000.0
34,St. Lawrence County PUMA,75,62,13,27706.666666666668,23032.25806451613,50000.0,13,0,13,50000.0,0.0,50000.0,35,35,0,13028.57142857143,13028.57142857143,0.0,27,27,0,36000.0,36000.0,0.0
35,Genesee & Orleans Counties PUMA,365,331,34,26452.054794520547,25471.29909365559,36000.0,34,0,34,36000.0,0.0,36000.0,331,331,0,25471.29909365559,25471.29909365559,0.0,0,0,0,#DIV/0!,0.0,0.0
36,Monroe County (Central)--Rochester City (West) PUMA,3566,1892,1674,43997.70050476724,58057.02959830867,28107.467144563918,1181,999,182,71329.80524978832,77375.87587587588,38142.857142857145,1774,533,1241,32560.710259301013,38770.73170731707,29893.55358581789,611,360,251,24374.140752864158,33001.666666666664,12000.0
37,Wayne & Seneca Counties PUMA,134,51,83,59788.05970149254,124541.17647058824,20000.0,30,30,0,205000.0,205000.0,0.0,83,0,83,20000.0,0.0,20000.0,21,21,0,9600.0,9600.0,0.0
38,Warren & Washington Counties PUMA,358,173,185,65163.12849162011,80245.08670520231,51059.45945945946,25,0,25,93000.0,0.0,93000.0,227,67,160,71960.35242290748,137522.38805970148,44506.25,106,106,0,44041.50943396227,44041.50943396227,0.0
39,Erie County (North Central) PUMA,798,85,713,56133.709273182954,62000.0,55434.361851332396,464,85,379,74510.99137931035,62000.0,77316.88654353561,334,0,334,30603.59281437126,0.0,30603.59281437126,0,0,0,#DIV/0!,0.0,0.0
40,"Clinton, Franklin, Essex & Hamilton Counties PUMA",723,512,211,46648.96265560166,32615.625,80701.42180094786,461,275,186,62213.882863340565,44009.454545454544,89129.03225806452,190,165,25,19566.315789473683,19803.636363636364,18000.0,72,72,0,18458.333333333332,18458.333333333332,0.0
41,Dutchess County (North & East) PUMA,2069,1294,775,88742.96761720638,93661.66924265842,80530.32258064517,958,550,408,118958.24634655533,148365.45454545456,79316.17647058824,947,580,367,66043.50580781414,56022.75862068965,81880.10899182562,164,164,0,43317.07317073171,43317.07317073171,0.0
42,Tompkins County PUMA,1366,799,567,34240.55636896047,33970.71339173967,34620.811287477954,949,681,268,28766.069546891464,34970.63142437592,13000.0,417,118,299,46699.28057553957,28200.0,54000.0,0,0,0,#DIV/0!,0.0,0.0
43,"NYC-Manhattan Community District 4 & 5--Chelsea, Clinton & Midtown Business District PUMA",4261,3213,1048,103886.0103262145,123671.30718954248,43227.46183206107,2673,2070,603,95396.6479610924,104479.88405797101,64215.38971807629,1588,1143,445,118175.7241813602,158427.42782152232,14787.640449438202,0,0,0,#DIV/0!,0.0,0.0
44,Onondaga County (Central)--Syracuse City PUMA,2050,887,1163,33557.20975609756,36406.20067643743,31384.33361994841,386,230,156,45803.886010362694,49740.434782608696,40000.0,1199,495,704,31868.457047539618,28032.323232323233,34565.73863636364,465,162,303,27745.59139784946,43061.72839506173,19556.76567656766
45,Suffolk County (South Central)--Brookhaven Town (South) PUMA,2540,1533,1007,65175.27559055118,74559.3607305936,50889.47368421053,691,279,412,108801.73661360347,203376.3440860215,44757.28155339806,1517,922,595,53439.156229400134,52344.3600867679,55135.63025210084,332,332,0,28000.0,28000.0,0.0
46,Suffolk County (Northwest)--Smithtown Town PUMA,2305,1191,1114,54088.373101952275,50426.70025188917,58003.141831238776,1202,475,727,47707.98668885191,20136.842105263157,65722.14580467675,949,716,233,67701.47523709167,70521.22905027933,59036.48068669528,154,0,154,20000.0,0.0,20000.0
47,Herkimer (North & Central) & Oneida (Outer) Counties PUMA,217,123,94,38949.30875576037,40650.40650406504,36723.40425531915,89,77,12,47033.70786516854,50000.0,28000.0,128,46,82,33328.125,25000.0,38000.0,0,0,0,#DIV/0!,0.0,0.0
48,NYC-Queens Community District 2--Sunnyside & Woodside PUMA,6322,3191,3131,63047.09901929769,71029.11313068004,54912.12392206963,3263,1284,1979,73107.95586883236,85715.73208722741,64927.87266296109,2791,1639,1152,50450.91365102114,59408.724832214764,37706.25,268,268,0,71731.34328358209,71731.34328358209,0.0
49,Onondaga County (Central)--Syracuse City (Outer) PUMA,1114,482,632,100179.56014362657,174586.09958506224,43432.80063291139,482,482,0,174586.09958506224,174586.09958506224,0.0,632,0,632,43432.80063291139,0.0,43432.80063291139,0,0,0,#DIV/0!,0.0,0.0
50,Broome County (West Central)--Greater Binghamton City & Greater Johnson City Village PUMA,537,416,121,36618.24953445065,29925.48076923077,59628.09917355372,195,159,36,31076.923076923078,20000.0,80000.0,342,257,85,39777.77777777778,36066.14785992218,51000.0,0,0,0,#DIV/0!,0.0,0.0
51,Erie County (West Central)--Buffalo City (West) PUMA,3587,1516,2071,51366.016169500974,37787.66490765171,61305.55287300821,1194,189,1005,78519.09547738693,54285.71428571428,83076.41791044777,1791,828,963,40127.86152987158,35315.942028985504,44265.21287642783,602,499,103,30945.3488372093,35640.28056112224,8200.0
52,"Steuben (North & West), Schuyler & Chemung (North) Counties PUMA",459,102,357,37250.56427015251,19529.41176470588,42313.750700280114,182,0,182,12620.92857142857,0.0,12620.92857142857,247,72,175,56279.35222672065,15166.666666666666,73194.28571428571,30,30,0,30000.0,30000.0,0.0
53,Monroe County (North & West) PUMA,525,275,250,66413.33333333333,108909.09090909091,19668.0,135,135,0,170000.0,170000.0,0.0,390,140,250,30556.410256410258,50000.0,19668.0,0,0,0,#DIV/0!,0.0,0.0
54,NYC-Brooklyn Community District 8--Crown Heights North & Prospect Heights PUMA,2845,1182,1663,90294.0949033392,57096.023688663285,113890.07817197836,1546,424,1122,104624.83829236739,75146.22641509434,115764.70588235294,1252,711,541,73547.68370607028,45809.42334739803,110002.21811460258,47,47,0,65000.0,65000.0,0.0
55,Cattaraugus & Allegany Counties PUMA,521,213,308,34290.825335892514,31590.23474178404,36158.44155844156,151,80,71,43152.317880794704,49500.0,36000.0,365,128,237,29971.287671232876,18427.5,36205.90717299578,5,5,0,82000.0,82000.0,0.0
56,"NYC-Queens Community District 11--Bayside, Douglaston & Little Neck PUMA",3303,1739,1564,85173.59975779595,95708.68315123634,73459.71867007672,1623,735,888,107685.02772643253,124828.29931972788,93495.49549549549,1680,1004,676,63425.95238095238,74391.03585657371,47140.5325443787,0,0,0,#DIV/0!,0.0,0.0
57,Chemung (South) & Steuben (East) Counties--Greater Elmira & Greater Corning Cities PUMA,452,229,223,50106.19469026549,45611.35371179039,54721.973094170404,118,118,0,28533.898305084746,28533.898305084746,0.0,334,111,223,57727.54491017964,63765.76576576577,54721.973094170404,0,0,0,#DIV/0!,0.0,0.0
58,Suffolk County (Southwest)--Babylon Town (Southeast) PUMA,3018,1994,1024,51311.76275679258,56622.51755265798,40970.3125,533,108,425,86147.09193245778,125000.0,76273.88235294117,2099,1500,599,40590.51929490233,50441.53333333333,15921.86978297162,386,386,0,61510.362694300515,61510.362694300515,0.0
59,Jefferson & Lewis Counties PUMA,1375,1066,309,28524.8,33933.20825515947,9866.666666666666,147,40,107,19182.312925170067,25000.0,17007.47663551402,1034,962,72,32352.804642166346,34699.3762993763,1000.0,194,64,130,15201.030927835052,28000.0,8900.0
60,NYC-Brooklyn Community District 3--Bedford-Stuyvesant PUMA,4307,2435,1872,45683.70095193871,41112.52566735113,51629.64743589744,2368,1135,1233,49446.28378378379,45492.15859030837,53086.131386861314,1495,943,552,38181.20401337792,39443.69034994698,36024.45652173913,444,357,87,50878.37837837838,31596.638655462186,130000.0
61,Schenectady County--Schenectady City PUMA,1849,322,1527,55146.7820443483,161459.62732919256,32728.487229862476,293,160,133,209215.0170648464,300000.0,100000.0,1255,162,1093,19691.95219123506,24629.62962962963,18960.10978956999,301,0,301,53000.0,0.0,53000.0
62,NYC-Queens Community District 1--Astoria & Long Island City PUMA,6822,4008,2814,57652.67516857226,51327.53243512974,66661.62046908315,3525,1744,1781,69757.60283687944,61252.55160550459,78085.96294216732,2988,2103,885,45216.76706827309,43712.79125059439,48790.621468926554,309,161,148,39816.50485436893,43281.36645962733,36047.2972972973
63,Suffolk County (North Central)--Brookhaven Town (North) PUMA,1712,1186,526,70377.33644859813,77475.54806070826,54372.62357414448,880,754,126,99107.95454545454,95616.71087533157,120000.0,699,299,400,39035.76537911302,46173.913043478264,33700.0,133,133,0,45000.0,45000.0,0.0
64,Fulton & Montgomery Counties PUMA,2699,1842,857,35717.22860318636,39315.20086862106,27983.89731621937,229,0,229,10800.0,0.0,10800.0,1888,1260,628,41622.13983050847,45296.50793650794,34250.0,582,582,0,26365.9793814433,26365.9793814433,0.0
65,NYC-Brooklyn Community District 16--Brownsville & Ocean Hill PUMA,2983,1757,1226,28853.804894401608,27817.757541263516,30338.58075040783,738,137,601,31052.574525745258,7000.0,36535.440931780366,2005,1400,605,29776.60847880299,32199.14285714286,24170.743801652894,240,220,20,14383.333333333334,12900.0,30700.0
66,"Rockland County (South)--Orangetown, Clarkstown (South) & Ramapo (Southeast) Towns PUMA",2081,1043,1038,51532.18644882268,56809.395973154365,46229.55684007707,1219,891,328,51325.660377358494,57629.854096520765,34200.54878048781,825,152,673,46479.393939393936,52000.0,45232.54086181278,37,0,37,171000.0,0.0,171000.0
67,Oswego County PUMA,1315,822,493,44395.74144486692,51082.72506082725,33246.247464503045,129,0,129,88400.0,0.0,88400.0,1094,730,364,41258.50091407678,55000.0,13700.0,92,92,0,20000.0,20000.0,0.0
68,"NYC-Manhattan Community District 12--Washington Heights, Inwood & Marble Hill PUMA",16316,11267,5049,46763.79995096837,49085.31641075708,41583.264012675776,7534,3617,3917,57172.31218476241,76226.90074647497,39577.099821291806,7880,6748,1132,38822.27918781726,37194.59988144635,48525.08833922262,902,902,0,29204.434589800443,29204.434589800443,0.0
69,Monroe County (Central)--Rochester City (East) PUMA,5036,2528,2508,33001.05162827641,32789.729430379746,33214.059011164274,954,388,566,52923.769392033544,46862.67010309279,57078.727915194344,3360,1805,1555,28236.04761904762,31650.481994459835,24272.66881028939,722,335,387,28851.662049861498,22628.65671641791,34238.50129198966
70,Westchester County (Northeast) PUMA,2660,1312,1348,80744.7932330827,103964.93902439025,58144.77002967359,1369,625,744,119611.50474799123,187192.0,62840.25537634409,1247,643,604,39513.23175621492,27444.790046656297,52360.92715231788,44,44,0,40000.0,40000.0,0.0
71,"NYC-Bronx Community District 1 & 2--Hunts Point, Longwood & Melrose PUMA",13796,7063,6733,35790.7596404755,37524.18235877106,33972.377840487155,1920,515,1405,48221.416666666664,70211.6504854369,40160.93950177936,10055,5588,4467,35704.73396320239,36704.15175375805,34454.5108573987,1821,960,861,23159.308072487645,24761.979166666668,21372.357723577235
72,"NYC-Queens Community District 7--Flushing, Murray Hill & Whitestone PUMA",4785,2975,1810,40796.76698014629,45973.489075630256,32288.066298342543,1009,544,465,56716.67988107037,58174.13602941176,55011.6129032258,3345,2216,1129,39317.60837070254,46274.54873646209,25662.533215234722,431,215,216,15006.960556844548,12000.0,18000.0
73,Onondaga County (North) PUMA,912,500,412,34182.02850877193,35684.02,32359.223300970873,224,0,224,45669.642857142855,0.0,45669.642857142855,627,439,188,28791.068580542265,34054.66970387244,16500.0,61,61,0,47410.0,47410.0,0.0
74,Suffolk County (Central)--Brookhaven Town (West Central) PUMA,2192,992,1200,49833.53102189781,61107.8629032258,40513.416666666664,495,0,495,54328.080808080806,0.0,54328.080808080806,1191,910,281,53244.08060453401,61928.57142857143,25119.928825622777,506,82,424,37409.09090909091,52000.0,34587.264150943396
75,Monroe County (South) PUMA,958,387,571,60377.34864300626,79015.50387596899,47745.18388791594,407,218,189,87353.80835380836,92981.6513761468,80862.43386243386,551,169,382,40450.99818511797,61000.0,31359.947643979056,0,0,0,#DIV/0!,0.0,0.0
76,"NYC-Brooklyn Community District 15--Sheepshead Bay, Gerritsen Beach & Homecrest PUMA",2379,1552,827,86213.82934005884,96724.22680412371,66489.35912938332,1519,1297,222,105322.05398288347,103823.43870470316,114077.47747747747,656,51,605,47314.78658536585,27000.0,49027.27272727273,204,204,0,69019.60784313726,69019.60784313726,0.0
77,Rensselaer County--Troy City PUMA,1077,512,565,50512.906220984216,53587.5,47726.72566371682,342,230,112,61929.82456140351,67252.17391304347,51000.0,735,282,453,45200.54421768708,42442.55319148936,46917.43929359823,0,0,0,#DIV/0!,0.0,0.0
78,Suffolk County (Central)--Islip Town (East) PUMA,1767,654,1113,52339.83022071308,66912.96636085627,43776.639712488766,795,358,437,69089.40880503145,70058.88268156424,68295.19450800915,972,296,676,38640.329218107,63108.10810810811,27926.62721893491,0,0,0,#DIV/0!,0.0,0.0
79,Nassau County (West Central)--Hempstead Town (Northwest) PUMA,3789,2136,1653,85075.0593824228,102628.08988764045,62393.10344827586,1969,941,1028,120558.04977145759,166163.65568544102,78812.06225680934,1675,1050,625,42072.0,46051.04761904762,35387.2,145,145,0,100000.0,100000.0,0.0
80,Ontario & Yates Counties PUMA,1654,1068,586,29715.054413542926,30248.78277153558,28742.32081911263,311,245,66,20000.0,20000.0,20000.0,923,403,520,37409.209100758395,47160.54590570719,29851.923076923078,420,420,0,20000.0,20000.0,0.0
81,Suffolk County (West Central)--Babylon Town (Northwest) PUMA,4103,2321,1782,35625.5422861321,37671.86557518311,32960.26936026936,1053,368,685,58119.65811965812,72701.08695652174,50286.131386861314,2025,1326,699,32802.27160493827,35978.43137254902,26777.110157367668,1025,627,398,18094.634146341465,20693.77990430622,14000.0
82,Nassau County (Southwest)--Hempstead Town (Southwest) & Long Beach City PUMA,2093,1185,908,48940.65934065934,55102.95358649789,40898.45814977973,727,104,623,53349.10591471802,76288.46153846153,49519.743178170145,1366,1081,285,46594.436310395315,53064.75485661424,22052.63157894737,0,0,0,#DIV/0!,0.0,0.0
83,"NYC-Bronx Community District 8--Riverdale, Fieldston & Kingsbridge PUMA",8262,4012,4250,63082.77656741709,69608.3000997009,56922.68235294118,3298,973,2325,70081.59490600364,90696.91675231243,61454.1935483871,4131,2495,1636,58490.19607843137,66105.57114228456,46876.28361858191,833,544,289,58148.619447779114,47954.044117647056,77338.40830449827
84,"Rockland County (West)--Spring Valley, Suffern Villages & Monsey PUMA",865,542,323,64864.48554913295,79604.20664206642,40130.95975232198,281,281,0,65037.29537366548,65037.29537366548,0.0,584,261,323,64781.33561643836,95287.35632183908,40130.95975232198,0,0,0,#DIV/0!,0.0,0.0
85,Chautauqua County PUMA,932,206,726,30465.236051502146,34854.36893203884,29219.834710743802,206,0,206,44174.7572815534,0.0,44174.7572815534,623,206,417,26240.449438202246,34854.36893203884,21985.131894484413,103,0,103,28600.0,0.0,28600.0
86,Orange County (Southeast) PUMA,3884,2895,989,71210.9165808445,72978.65284974093,66036.40040444894,1500,736,764,68874.66666666667,69459.23913043478,68311.51832460733,2384,2159,225,72680.87248322148,74178.41593330246,58311.11111111111,0,0,0,#DIV/0!,0.0,0.0
87,Monroe County (East) PUMA,1657,863,794,44355.22027761014,59382.38702201622,28022.166246851386,126,0,126,59603.1746031746,0.0,59603.1746031746,1209,672,537,51126.2200165426,71997.02380952382,25008.56610800745,322,191,131,12965.83850931677,15000.0,10000.0
88,Broome (Outer West) & Tioga Counties PUMA,855,855,0,77059.64912280702,77059.64912280702,0.0,124,124,0,130000.0,130000.0,0.0,318,318,0,50000.0,50000.0,0.0,413,413,0,82000.0,82000.0,0.0
89,Suffolk County (East) PUMA,1182,914,268,59582.74111675127,56483.5886214442,70152.23880597015,87,26,61,94609.19540229885,150000.0,71000.0,998,791,207,60376.55310621243,57883.69152970923,69902.4154589372,97,97,0,20000.0,20000.0,0.0
90,"NYC-Queens Community District 14--Far Rockaway, Breezy Point & Broad Channel PUMA",3842,2427,1415,55716.085372201975,48677.379480840544,67788.83392226149,839,447,392,122276.51966626936,120751.67785234899,124015.30612244898,2376,1422,954,41923.90572390572,38334.739803094235,47273.79454926625,627,558,69,18915.470494417863,17297.491039426524,32000.0
91,NYC-Brooklyn Community District 14--Flatbush & Midwood PUMA,2225,1535,690,49410.0404494382,49393.70684039088,49446.3768115942,587,239,348,70360.37478705282,71357.9079497908,69675.28735632185,786,444,342,24919.847328244276,21882.882882882885,28862.573099415204,852,852,0,57569.01408450704,57569.01408450704,0.0
92,Albany County (Outside Albany City) PUMA,1760,634,1126,84832.04545454546,168659.6214511041,37632.50444049734,1092,313,779,110065.56776556777,283555.910543131,40357.637997432605,395,118,277,42454.6835443038,96898.30508474576,19262.093862815884,273,203,70,45213.18681318681,33217.73399014778,80000.0
93,"NYC-Bronx Community District 5--Morris Heights, Fordham South & Mount Hope PUMA",8913,3503,5410,32200.492538987994,27971.53868113046,34938.75970425139,1607,152,1455,47148.22650902302,29210.526315789473,49022.13058419244,5718,2305,3413,28563.551941238195,24793.449023861172,31109.724582478757,1588,1046,542,30169.64735516373,34794.83747609943,21243.542435424355
94,"NYC-Manhattan Community District 9--Hamilton Heights, Manhattanville & West Harlem PUMA",5421,3254,2167,47322.32060505442,52239.950829748006,39937.93262574988,1650,863,787,60515.757575757576,65006.952491309385,55590.851334180436,3355,1975,1380,44419.94038748137,53789.06329113924,31011.231884057972,416,416,0,18400.0,18400.0,0.0
95,Nassau County (West Central)--Hempstead Town (West Central) PUMA,5428,2780,2648,61164.506816507004,68054.65575539568,53930.891238670694,1339,602,737,100736.37042569081,142259.13621262458,66819.53867028494,3193,1377,1816,50885.98277481992,58326.755991285405,45243.94273127753,896,801,95,38656.25,29008.739076154805,120000.0
96,Erie County (West Central)--Buffalo City (East) PUMA,1399,800,599,28738.098641887063,22489.5,37083.47245409015,579,105,474,33062.17616580311,16000.0,36841.77215189873,611,486,125,27081.178396072013,24272.83950617284,38000.0,209,209,0,21602.87081339713,21602.87081339713,0.0
97,NYC-Queens Community District 6--Forest Hills & Rego Park PUMA,3389,1822,1567,82798.02242549424,101977.61251372118,60497.31206126356,2307,1187,1120,96281.05765062853,123721.14574557709,67199.46428571429,899,523,376,61270.45383759733,69323.6137667304,50068.85106382979,183,112,71,18579.016393442624,24017.5,10000.0
98,"NYC-Queens Community District 13--Queens Village, Cambria Heights & Rosedale PUMA",6404,2358,4046,59057.27670206121,61927.39609838847,57384.57736035591,2398,540,1858,69884.48707256047,73505.55555555556,68832.07750269107,4006,1818,2188,52576.08587119321,58488.33883388339,47663.6197440585,0,0,0,#DIV/0!,0.0,0.0
99,"NYC-Bronx Community District 11--Pelham Parkway, Morris Park & Laconia PUMA",11734,5228,6506,50313.28362024885,52091.702371843916,48884.20688595143,3028,919,2109,72816.04359313077,93070.18498367791,63990.27027027027,7988,3770,4218,44033.686780170254,46608.99734748011,41731.903745851116,718,539,179,25275.766016713093,20571.428571428572,39441.340782122905
100,Madison & Cortland Counties PUMA,531,83,448,39262.523540489645,46506.02409638554,37920.53571428572,318,18,300,38962.264150943396,70000.0,37100.0,213,65,148,39710.79812206573,40000.0,39583.78378378379,0,0,0,#DIV/0!,0.0,0.0
101,Nassau County (Central)--Hempstead Town (East Central) PUMA,1142,741,401,95026.61996497372,122121.99730094467,44957.60598503741,634,401,233,119198.738170347,153975.06234413965,59347.63948497854,454,286,168,67863.43612334802,93041.95804195805,25000.0,54,54,0,39600.0,39600.0,0.0
102,Nassau County (West Central)--North Hempstead Town (South) PUMA,3127,2152,975,54928.87751838823,51759.10780669145,61925.1282051282,1429,1148,281,75914.9755073478,75548.3449477352,77412.81138790035,1698,1004,694,37267.43227326266,24557.868525896414,55654.178674351584,0,0,0,#DIV/0!,0.0,0.0
103,Westchester County (Central)--White Plains City PUMA,5919,4138,1781,65143.103733738804,63203.17327211213,69650.36496350366,2850,1601,1249,73553.95789473684,68122.41099312929,80516.25300240192,2149,2050,99,68085.15588645882,70267.26829268293,22900.0,920,487,433,32215.490217391303,17295.381930184805,48996.304849884524
104,"NYC-Staten Island Community District 3--Tottenville, Great Kills & Annadale PUMA",3136,1731,1405,73096.9387755102,60216.0600808781,88966.54804270463,1006,281,725,104164.01590457256,48686.832740213526,125666.20689655172,2037,1450,587,60817.378497790865,62450.34482758621,56783.64565587734,93,0,93,6000.0,0.0,6000.0
105,Suffolk County (Northwest)--Huntington Town (South) PUMA,1607,976,631,73546.48413192284,70789.1393442623,77811.41045958796,317,0,317,109675.07886435332,0.0,109675.07886435332,1290,976,314,64668.37209302326,70789.1393442623,45643.31210191083,0,0,0,#DIV/0!,0.0,0.0
106,NYC-Manhattan Community District 3--Chinatown & Lower East Side PUMA,6260,2627,3633,48554.54952076677,29813.962695089456,62105.752821359754,1830,344,1486,75179.22404371585,56774.651162790695,79439.77119784657,3442,1887,1555,36142.79488669378,27737.572866984632,46342.57234726688,988,396,592,42479.75708502025,16287.878787878788,60000.0
107,NYC-Brooklyn Community District 13--Brighton Beach & Coney Island PUMA,1981,1202,779,42386.723876829885,52710.48252911813,26457.124518613608,82,82,0,55000.0,55000.0,0.0,1608,905,703,42667.848258706465,57632.044198895026,23403.84068278805,291,215,76,37279.037800687285,31120.93023255814,54700.0
108,NYC-Brooklyn Community District 7--Sunset Park & Windsor Terrace PUMA,4703,2109,2594,44729.100574101634,50969.13229018492,39655.767154973015,1327,599,728,51454.96608892238,57582.47078464107,46413.241758241755,2222,989,1233,47911.84518451845,61543.983822042464,36977.388483373885,1154,521,633,30866.637781629117,23291.746641074857,37101.26382306477
109,Suffolk County (Northwest)--Huntington Town (North) PUMA,2399,1126,1273,43009.83743226344,53473.35701598579,33754.59544383347,704,566,138,69468.75,66291.51943462898,82500.0,1695,560,1135,32020.412979351033,40517.857142857145,27827.84140969163,0,0,0,#DIV/0!,0.0,0.0
110,Suffolk County (Southwest)--Islip Town (South) PUMA,4622,3451,1171,62984.119428818696,67036.27933932193,51042.18616567037,1580,557,1023,81996.83544303797,135529.62298025136,52849.4623655914,2328,2328,0,56696.3058419244,56696.3058419244,0.0,714,566,148,41412.60504201681,42161.13074204947,38550.0
111,"NYC-Brooklyn Community District 17--East Flatbush, Farragut & Rugby PUMA",1441,634,807,49075.14226231784,43882.14511041009,53154.8946716233,231,81,150,67792.20779220779,60000.0,72000.0,1210,553,657,45501.884297520664,41521.30198915009,48852.359208523594,0,0,0,#DIV/0!,0.0,0.0
112,Ulster County (East) PUMA,1552,1212,340,30587.56443298969,28897.607260726072,36611.76470588235,187,45,142,56844.91978609626,110000.0,40000.0,1365,1167,198,26990.40293040293,25770.26563838903,34181.818181818184,0,0,0,#DIV/0!,0.0,0.0
113,NYC-Manhattan Community District 10--Central Harlem PUMA,8035,4823,3212,44564.704418170506,52046.858801575785,33329.82565379826,3487,2312,1175,63102.724404932604,69520.84775086505,50474.04255319149,2956,982,1974,32508.491204330177,50259.36863543788,23678.01418439716,1592,1529,63,26346.168341708544,26772.46566383257,16000.0
114,NYC-Brooklyn Community District 4--Bushwick PUMA,8692,3538,5154,40523.957662218134,40403.50480497456,40606.64338377959,2195,906,1289,52955.398633257406,44825.7174392936,58669.511249030256,4746,1621,3125,36288.714707121784,44177.97655768044,32196.3968,1751,1011,740,36419.7030268418,30388.72403560831,44659.32432432433
115,"NYC-Brooklyn Community District 9--Crown Heights South, Prospect Lefferts & Wingate PUMA",1351,560,791,53897.03923019985,46887.32142857143,58859.67130214918,1128,410,718,57183.51063829787,53560.9756097561,59252.08913649025,142,69,73,44844.366197183095,34100.0,55000.0,81,81,0,24000.0,24000.0,0.0
116,Oneida County (Central)--Greater Utica & Rome Cities PUMA,1586,809,777,36963.46153846154,39025.83436341162,34816.151866151864,158,29,129,61800.63291139241,155000.0,40848.83720930233,1249,693,556,36117.01361088871,38042.568542568544,33716.996402877696,179,87,92,20946.368715083798,8200.0,33000.0
117,"NYC-Bronx Community District 9--Castle Hill, Clason Point & Parkchester PUMA",15495,7593,7902,41167.421748951274,40489.61411826682,41818.72437357631,2719,848,1871,63343.710923133505,57867.62971698113,65825.65473009086,10806,5866,4940,39485.52193225986,38965.69894306171,40102.78542510122,1970,879,1091,19785.329949238578,33894.31171786121,8417.965169569203
118,Erie County (Central) PUMA,1329,902,427,34024.454477050414,36140.465631929044,29554.56674473068,307,307,0,38959.60912052117,38959.60912052117,0.0,731,512,219,31476.060191518467,32478.90625,29131.50684931507,291,83,208,35219.58762886598,48300.0,30000.0
119,Livingston & Wyoming Counties PUMA,589,589,0,50675.72156196944,50675.72156196944,0.0,58,58,0,75000.0,75000.0,0.0,531,531,0,48018.832391713746,48018.832391713746,0.0,0,0,0,#DIV/0!,0.0,0.0
120,Nassau County (East Central)--Oyster Bay Town (Central) PUMA,1447,763,684,75671.04353835522,76633.02752293578,74597.95321637427,283,93,190,129169.61130742049,170000.0,109184.21052631579,1164,670,494,62664.08934707904,63673.13432835821,61295.54655870445,0,0,0,#DIV/0!,0.0,0.0
121,Niagara County (North & East) PUMA,703,251,452,48357.89473684211,46480.478087649404,49400.44247787611,231,0,231,34476.19047619047,0.0,34476.19047619047,350,129,221,62420.0,58000.0,65000.0,122,122,0,34300.0,34300.0,0.0
122,Westchester County (Southwest)--Yonkers City PUMA,10138,5641,4497,63776.09193134741,71050.04786385392,54651.701134089395,4239,1308,2931,75948.95494220335,101577.15596330275,64512.00955305356,5178,3781,1397,55705.755117806104,63218.03755620206,35373.65783822477,721,552,169,50166.43550624133,52360.50724637681,43000.0
123,Sullivan & Ulster (West) Counties PUMA,2150,1362,788,47246.651162790695,27020.704845814977,82205.71065989848,614,278,336,89202.7687296417,19451.438848920865,146913.69047619047,1136,724,412,32375.704225352114,30220.580110497238,36162.8640776699,400,360,40,25077.5,26430.555555555555,12900.0
124,"NYC-Brooklyn Community District 12--Borough Park, Kensington & Ocean Parkway PUMA",1609,776,833,62221.00683654444,71855.67010309278,53245.61824729892,571,260,311,79924.6935201401,74284.61538461539,84639.87138263666,928,406,522,54720.474137931036,80665.02463054187,34541.379310344826,110,110,0,33600.0,33600.0,0.0
125,NYC-Brooklyn Community District 11--Bensonhurst & Bath Beach PUMA,4273,3086,1187,56638.895389655976,61595.88464031108,43751.55855096883,641,406,235,77273.01092043682,94639.16256157635,47270.21276595745,3285,2613,672,56140.45662100457,57271.87141216992,51741.07142857143,347,67,280,23240.92219020173,30000.0,21623.571428571428
126,"NYC-Bronx Community District 7--Bedford Park, Fordham North & Norwood PUMA",9781,6506,3275,38994.05377773234,43373.748847217954,30293.50534351145,2295,1130,1165,58316.339869281044,64760.176991150445,52066.09442060086,5783,3970,1813,36070.17292062943,43303.680100755664,20230.667402095973,1703,1406,297,22883.752201996478,26383.357041251777,6316.599326599327
127,NYC-Manhattan Community District 11--East Harlem PUMA,6888,2786,4102,41473.44076655052,40365.64967695621,42225.831301804,1948,664,1284,62179.05544147844,74573.7951807229,55769.314641744546,4671,2122,2549,33878.754014129736,29661.498586239395,37389.548842683405,269,0,269,23407.434944237917,0.0,23407.434944237917
128,Westchester County (Southeast) PUMA,1961,1411,550,93162.21315655278,91676.18710134656,96974.54545454546,430,187,243,133520.93023255814,96085.5614973262,162329.2181069959,1265,958,307,88013.51778656126,101719.31106471816,45244.2996742671,266,266,0,52406.015037593985,52406.015037593985,0.0
129,Niagara County (Southwest)--Greater Niagara Falls & North Tonawanda Area PUMA,742,441,301,36960.91644204852,37977.32426303855,35471.76079734219,57,57,0,40000.0,40000.0,0.0,685,384,301,36708.029197080294,37677.083333333336,35471.76079734219,0,0,0,#DIV/0!,0.0,0.0
130,Erie County (Northeast) PUMA,1177,1060,117,37372.982158028884,38186.79245283019,30000.0,117,0,117,30000.0,0.0,30000.0,368,368,0,52690.217391304344,52690.217391304344,0.0,692,692,0,30473.98843930636,30473.98843930636,0.0
131,Monroe County (Central)--Greece & Gates Towns PUMA,2347,1520,827,33767.27737537282,33106.44736842105,34981.86215235792,601,272,329,51468.885191347756,60021.32352941176,44398.176291793316,1385,949,436,28818.772563176895,27946.259220231823,30717.889908256882,361,299,62,23282.548476454293,25000.0,15000.0
132,NYC-Brooklyn Community District 10--Bay Ridge & Dyker Heights PUMA,4260,2529,1731,44754.55399061033,44019.49387109529,45828.480647024844,958,410,548,65146.555323590816,84813.90243902439,50431.93430656935,2916,1782,1134,42406.44718792867,40736.25140291807,45031.0405643739,386,337,49,11882.901554404145,11749.554896142434,12800.0
133,"NYC-Bronx Community District 10--Co-op City, Pelham Bay & Schuylerville PUMA",10097,4208,5889,61391.003268297514,77435.35171102661,49926.47308541348,3281,1346,1935,78010.22858884487,112078.35066864785,54312.19638242894,6249,2364,3885,53379.05264842375,61477.495769881556,48451.19691119691,567,498,69,53523.28042328043,59553.614457831325,10000.0
134,"NYC-Manhattan Community District 1 & 2--Battery Park City, Greenwich Village & Soho PUMA",2071,827,1244,171595.60598744568,152389.96372430472,184363.34405144694,2071,827,1244,171595.60598744568,152389.96372430472,184363.34405144694,0,0,0,#DIV/0!,0.0,0.0,0,0,0,#DIV/0!,0.0,0.0
135,Albany County (East Central)--Albany City PUMA,1406,530,876,91232.85917496444,134358.49056603774,65140.86757990868,618,100,518,164984.142394822,601000.0,80811.19691119691,634,276,358,37859.93690851735,31884.057971014492,42467.039106145254,154,154,0,15000.0,15000.0,0.0
136,"NYC-Queens Community District 8--Briarwood, Fresh Meadows & Hillcrest PUMA",4381,2957,1424,61739.57041771285,64065.15319580656,56910.393258426964,1495,794,701,68939.745819398,65986.04534005038,72285.30670470756,2670,1947,723,60388.965543071165,67216.3009758603,42003.319502074686,216,216,0,28600.0,28600.0,0.0
137,NYC-Queens Community District 4--Elmhurst & South Corona PUMA,3534,1934,1600,41767.94001131862,42524.1468459152,40853.875,1251,625,626,40233.25339728218,33286.4,47169.009584664534,2283,1309,974,42608.89180902322,46934.83575248281,36795.07186858316,0,0,0,#DIV/0!,0.0,0.0
138,Nassau County (Central)--Hempstead Town (North Central)--Meadowbrook Corridor PUMA,5614,3665,1949,40120.63056644104,41945.54433833561,36688.96870189841,1542,1220,322,60729.13099870298,67118.29508196721,36521.739130434784,3361,2038,1323,34390.1517405534,30381.99214916585,40564.474678760394,711,407,304,22514.20534458509,24392.13759213759,20000.0
139,"NYC-Brooklyn Community District 6--Park Slope, Carroll Gardens & Red Hook PUMA",2946,1228,1718,72515.52953156823,88164.332247557,61330.005820721766,1437,448,989,106771.22477383437,187990.4017857143,69980.33367037412,1205,476,729,44362.24066390042,36348.94957983193,49594.51303155007,304,304,0,22184.21052631579,22184.21052631579,0.0
140,"NYC-Bronx Community District 4--Concourse, Highbridge & Mount Eden PUMA",9877,3681,6196,35145.81755593804,34538.28850855746,35506.74628792769,1882,161,1721,46364.261424017,28571.67701863354,48028.7623474724,6808,2852,3956,34326.6598119859,36930.57503506311,32449.418604651164,1187,668,519,22057.118786857623,25762.574850299403,17287.861271676302
141,NYC-Manhattan Community District 8--Upper East Side PUMA,5937,2791,3146,65206.400538992755,65993.90899319241,64507.75588048315,4467,1704,2763,75185.44884710097,85640.25821596244,68737.74882374231,383,0,383,33992.167101827676,0.0,33992.167101827676,1087,1087,0,35195.95216191353,35195.95216191353,0.0
142,Orange County (Northeast)--Greater Newburgh City PUMA,5489,3017,2472,54699.763162689014,57965.9264169705,50713.51132686084,1489,604,885,78276.09133646743,101112.91390728476,62690.28248587571,3303,1932,1371,50250.953678474114,52310.55900621118,47348.577680525166,697,481,216,25416.06886657102,26501.0395010395,23000.0
143,"NYC-Bronx Community District 12--Wakefield, Williamsbridge & Woodlawn PUMA",5801,2309,3492,47064.52335804172,46636.2494586401,47347.70904925544,1965,554,1411,46397.557251908394,57000.72202166065,42234.44365698087,3642,1654,1988,46601.345414607356,44302.72067714631,48513.78269617706,194,101,93,62515.463917525776,28000.0,100000.0
144,NYC-Queens Community District 10--Howard Beach & Ozone Park PUMA,7294,3443,3851,51622.97504798465,60342.57914609352,43827.18254998702,2029,550,1479,71288.86150813209,121610.90909090909,52575.45638945233,4886,2708,2178,45692.77118297176,49996.12259970458,40342.23140495868,379,185,194,22791.55672823219,29643.243243243243,16257.731958762886
145,Suffolk County (Central)--Islip Town (Northwest) PUMA,6545,4025,2520,48371.22077922078,44259.32919254658,54938.8253968254,865,298,567,95033.5260115607,117466.44295302013,83243.38624338624,3300,2363,937,43715.64848484848,44296.99534490055,42249.56243329776,2380,1364,1016,37867.226890756305,28200.146627565984,50845.47244094488
146,Capital Region,9817,4194,5623,496567.9164353151,735857.6605712987,399777.08054078434,3216,1329,1887,863023.72166189,1474291.8901241906,523764.46332393005,4790,1779,3011,358720.2964029843,439975.94048433413,330220.20679110393,1811,1086,725,#DIV/0!,171134.70129956794,160000.0
147,Central NY,6667,3087,3580,320234.781514658,396992.22596823325,258543.14073261942,1971,730,1241,473621.89260351117,294326.53436767095,291369.64285714284,3970,1934,2036,240194.30822396502,212219.67586302492,147782.32305305882,726,423,303,#DIV/0!,158632.83950617284,19556.76567656766
148,Finger Lakes,16831,9504,7327,448542.8222338916,602197.1681019344,276481.05926196603,3837,2345,1492,828679.4427901526,747241.5208845272,336085.36981545325,10537,5533,5004,342648.4994857241,402015.17412260914,210772.54913327374,2457,1626,831,#DIV/0!,125230.32338308457,71238.50129198967
149,Long Island,72402,42150,30252,1607827.4861593514,1709123.5016476929,1548663.2774840589,22022,10374,11648,2206525.4421502016,2455122.2198834503,1999860.943551441,42261,26410,15851,1316325.1957244128,1450409.479915796,966308.4165143092,8119,5366,2753,#DIV/0!,651671.5597944092,348982.73659188824
150,Mid-Hudson,65686,35456,30230,1114549.8078857744,1158159.9359328647,1075072.9723885253,27308,12108,15200,1495496.5575756945,1649795.5147850339,1341926.855820948,33394,19672,13722,887424.7340691347,956863.1452571036,741559.2815019113,4984,3676,1308,#DIV/0!,425714.36032027024,449896.30484988453
151,Mohawk Valley,5273,3030,2243,151392.61887146794,163022.3792360977,137164.34664157388,476,106,370,#DIV/0!,205000.0,79648.83720930232,4036,2255,1781,150829.89841545685,152370.01397907647,143607.8896067612,761,669,92,#DIV/0!,34565.9793814433,33000.0
152,New York City,335114,175954,159160,3231998.3415223286,3390504.8913186654,2954691.5981050935,112517,48987,63530,4120347.166752231,4469299.23174702,3666040.2477911096,192521,106047,86474,#DIV/0!,2716015.315301357,2227268.1833268576,30076,20920,9156,#DIV/0!,1433184.7954595746,1133892.7475263104
153,North Country,2173,1640,533,102880.42932226833,89581.0913196756,140568.08846761452,621,315,306,131396.19578851064,69009.45454545454,156136.50889357855,1259,1162,97,64947.69186021146,67531.5840915841,19000.0,293,163,130,69659.36426116838,82458.33333333333,8900.0
154,Southern Tier,4096,2538,1558,292240.31937305303,319096.6087602737,221778.08253134426,1705,1219,486,343997.81950032787,326504.52972946066,105620.92857142857,1948,876,1072,280977.4037660797,193198.58029235463,263409.7070843182,443,443,0,#DIV/0!,112000.0,0.0
155,Western NY,13077,6018,7059,436666.6748808555,409149.213122882,461171.4817937026,3735,914,2821,545966.3803851104,303745.32340623543,427997.2669671763,7318,3494,3824,395348.4554483039,312359.2415477951,368947.061930569,2024,1610,414,#DIV/0!,252317.13981382572,66800.0
