,puma,Total_geo,Total_geo_m,Total_geo_f,Total_Avg_PINCP_mf_t,Total_Avg_PINCP_m,Total_Avg_PINCP_f,Total_BABS,Total_BABS_m,Total_BABS_f,BABS_Avg_PINCP_mf_t,BABS_Avg_PINCP_m,BABS_Avg_PINCP_f,Total_HS,Total_HS_m,Total_HS_f,HS_Avg_PINCP_mf_t,HS_Avg_PINCP_m,HS_Avg_PINCP_f,Total_HSINC,Total_HSINC_m,Total_HSINC_f,HSINC_Avg_PINCP_mf_t,HSINC_Avg_PINCP_m,HSINC_Avg_PINCP_f
0,Total Geo,216766,134274,82492,38818.912001882214,39696.085504267394,37391.1178538525,42559,19906,22653,57093.98982588877,61126.179393147795,53550.76087052488,125376,76945,48431,36262.77163093415,38273.109987653515,33068.836241250436,48831,37423,11408,29454.156376072577,31222.77770355129,23652.3404628331
1,Westchester County (Southwest)--Yonkers City PUMA,5028,3221,1807,51581.88544152745,54878.261409500155,45706.05423353625,1445,839,606,87866.10380622838,93909.39213349225,79499.2409240924,2716,1710,1006,34927.687776141385,37992.33918128655,29718.389662027832,867,672,195,43279.815455594005,49116.07142857143,23167.17948717949
2,St. Lawrence County PUMA,36,21,15,115194.44444444444,156047.61904761905,58000.0,15,15,0,211000.0,211000.0,0.0,15,0,15,58000.0,0.0,58000.0,6,6,0,18666.666666666668,18666.666666666668,0.0
3,"NYC-Queens Community District 7--Flushing, Murray Hill & Whitestone PUMA",4638,3051,1587,43509.368262181975,45569.79351032448,39548.2104599874,619,267,352,54288.31987075929,63953.40823970037,46957.130681818184,3210,2267,943,43959.221183800626,44935.641817379794,41611.8769883351,809,517,292,33476.98393077874,38856.441005802706,23952.397260273974
4,Erie County (Central) PUMA,52,52,0,37280.769230769234,37280.769230769234,0.0,12,12,0,39150.0,39150.0,0.0,16,16,0,21600.0,21600.0,0.0,24,24,0,46800.0,46800.0,0.0
5,Monroe County (South) PUMA,178,92,86,54075.14606741573,38590.217391304344,70640.41860465116,86,0,86,70640.41860465116,0.0,70640.41860465116,73,73,0,38223.28767123288,38223.28767123288,0.0,19,19,0,40000.0,40000.0,0.0
6,Onondaga County (North) PUMA,144,70,74,64378.47222222222,50771.42857142857,77250.0,91,17,74,76829.67032967033,75000.0,77250.0,53,53,0,43000.0,43000.0,0.0,0,0,0,#DIV/0!,0.0,0.0
7,"NYC-Bronx Community District 9--Castle Hill, Clason Point & Parkchester PUMA",4626,2932,1694,36410.91655858193,40212.00545702592,29831.936245572608,447,281,166,52124.60850111857,50885.05338078292,54222.89156626506,3517,2076,1441,37489.08160363947,43992.96724470135,28119.15336571825,662,575,87,20072.658610271905,21345.217391304348,11662.068965517241
8,"Clinton, Franklin, Essex & Hamilton Counties PUMA",148,90,58,44970.2027027027,63450.0,16294.655172413793,35,27,8,111731.14285714286,121500.0,78761.25,78,28,50,10064.102564102564,16785.714285714286,6300.0,35,35,0,56000.0,56000.0,0.0
9,Suffolk County (Southwest)--Babylon Town (Southeast) PUMA,1254,505,749,39609.33014354067,38099.40594059406,40627.36982643525,43,14,29,91627.90697674418,100000.0,87586.20689655172,906,370,536,36447.79249448123,36372.43243243243,36499.81343283582,305,121,184,41666.88524590164,36218.181818181816,45250.0
10,Suffolk County (Northwest)--Smithtown Town PUMA,137,109,28,57494.890510948906,58429.35779816514,53857.142857142855,74,63,11,88713.51351351352,86742.85714285714,100000.0,17,0,17,24000.0,0.0,24000.0,46,46,0,19652.17391304348,19652.17391304348,0.0
11,"NYC-Bronx Community District 12--Wakefield, Williamsbridge & Woodlawn PUMA",1837,1038,799,42440.28307022319,50071.387283236996,32526.533166458074,452,152,300,42502.654867256635,43234.86842105263,42131.666666666664,1076,592,484,43261.52416356877,56334.7972972973,27271.07438016529,309,294,15,39489.320388349515,40993.87755102041,10000.0
12,Dutchess County (Southwest) PUMA,1387,1029,358,35237.454938716655,35046.413994169096,35786.564245810056,204,120,84,60649.46078431373,48300.0,78291.54761904762,768,543,225,32830.9375,36172.30202578269,24767.11111111111,415,366,49,27199.277108433736,29030.601092896173,13520.408163265307
13,Ulster County (East) PUMA,232,150,82,42290.862068965514,51287.2,25834.146341463416,68,36,32,57176.470588235294,85222.22222222222,25625.0,130,80,50,32488.30769230769,36563.5,25968.0,34,34,0,50000.0,50000.0,0.0
14,Orange County (Northwest) PUMA,1352,979,373,36080.69526627219,38235.34218590398,30425.469168900803,134,43,91,60744.77611940299,88344.18604651163,47703.296703296706,924,642,282,35562.229437229435,40267.60124610592,24850.0,294,294,0,26468.7074829932,26468.7074829932,0.0
15,"NYC-Bronx Community District 11--Pelham Parkway, Morris Park & Laconia PUMA",3312,2012,1300,40562.62077294686,44321.71968190855,34744.692307692305,627,230,397,57651.674641148325,76651.73913043478,46644.08060453401,1842,1035,807,35979.85884907709,39052.463768115944,32039.15737298637,843,747,96,37865.83629893239,41668.13922356091,8279.166666666666
16,"NYC-Manhattan Community District 1 & 2--Battery Park City, Greenwich Village & Soho PUMA",553,371,182,91179.20433996384,122749.32614555256,26824.725274725275,486,328,158,97092.79835390947,131832.31707317074,24975.316455696204,43,43,0,53465.11627906977,53465.11627906977,0.0,24,0,24,39000.0,0.0,39000.0
17,"NYC-Brooklyn Community District 12--Borough Park, Kensington & Ocean Parkway PUMA",1370,1003,367,34999.34306569343,32828.01595214357,40933.51498637602,304,148,156,56338.81578947369,56614.86486486487,56076.92307692308,513,405,108,30062.573099415204,27324.69135802469,40329.62962962963,553,450,103,27848.101265822785,29957.777777777777,18631.06796116505
18,"NYC-Staten Island Community District 1--Port Richmond, Stapleton & Mariner's Harbor PUMA",1666,1066,600,33930.81032412965,33486.772983114446,34719.71666666667,288,118,170,51724.0625,36796.61016949153,62085.470588235294,847,628,219,35763.63636363636,37946.019108280256,29505.479452054795,531,320,211,21356.68549905838,23515.0,18083.412322274882
19,Monroe County (Central)--Greece & Gates Towns PUMA,167,70,97,35435.928143712576,20282.85714285714,46371.134020618556,117,70,47,39314.529914529914,20282.85714285714,67659.5744680851,37,0,37,30000.0,0.0,30000.0,13,0,13,16000.0,0.0,16000.0
20,Westchester County (South Central)--New Rochelle & Mount Vernon Cities PUMA,1808,1379,429,47507.82632743363,43055.29369108049,61820.27972027972,360,146,214,90256.66666666667,94509.5890410959,87355.14018691589,830,712,118,36391.20481927711,34479.073033707864,47928.813559322036,618,521,97,37535.679611650485,40356.52591170825,22384.536082474227
21,Orange County (Northeast)--Greater Newburgh City PUMA,1799,883,916,40294.007782101166,37721.31370328426,42774.01746724891,141,0,141,84606.3829787234,0.0,84606.3829787234,1207,553,654,39126.69428334714,40879.240506329115,37644.80122324159,451,330,121,29564.30155210643,32429.39393939394,21750.413223140495
22,Suffolk County (East) PUMA,584,386,198,36675.95890410959,35639.27461139896,38696.969696969696,93,29,64,38172.04301075269,53275.862068965514,31328.125,317,200,117,37110.283911671926,30959.8,47623.931623931625,174,157,17,35085.057471264365,38342.67515923567,5000.0
23,Tompkins County PUMA,54,54,0,57111.11111111111,57111.11111111111,0.0,0,0,0,#DIV/0!,0.0,0.0,52,52,0,58346.153846153844,58346.153846153844,0.0,2,2,0,25000.0,25000.0,0.0
24,Monroe County (Central)--Rochester City (East) PUMA,174,127,47,70493.10344827586,43678.740157480315,142948.93617021278,38,13,25,47110.52631578947,100000.0,19608.0,136,114,22,77026.4705882353,37256.14035087719,283109.0909090909,0,0,0,#DIV/0!,0.0,0.0
25,Ontario & Yates Counties PUMA,103,63,40,22366.990291262136,21782.539682539682,23287.5,0,0,0,#DIV/0!,0.0,0.0,66,26,40,21512.121212121212,18780.76923076923,23287.5,37,37,0,23891.891891891893,23891.891891891893,0.0
26,"NYC-Bronx Community District 7--Bedford Park, Fordham North & Norwood PUMA",6883,4122,2761,35476.86183350283,36059.38864628821,34607.18580224556,1192,398,794,48216.35906040268,51590.95477386934,46524.81108312342,4239,2840,1399,33888.652984194385,36127.957746478874,29342.816297355253,1452,884,568,29655.192837465565,28846.380090497736,30913.978873239437
27,Chautauqua County PUMA,72,62,10,20784.722222222223,22120.967741935485,12500.0,0,0,0,#DIV/0!,0.0,0.0,25,15,10,22100.0,28500.0,12500.0,47,47,0,20085.106382978724,20085.106382978724,0.0
28,Genesee & Orleans Counties PUMA,128,112,16,25078.125,22946.428571428572,40000.0,0,0,0,#DIV/0!,0.0,0.0,16,0,16,40000.0,0.0,40000.0,112,112,0,22946.428571428572,22946.428571428572,0.0
29,"NYC-Brooklyn Community District 15--Sheepshead Bay, Gerritsen Beach & Homecrest PUMA",393,267,126,36400.50890585242,31901.123595505618,45934.920634920636,59,41,18,32067.79661016949,22000.0,55000.0,182,74,108,39817.58241758242,33094.59459459459,44424.07407407407,152,152,0,33990.78947368421,33990.78947368421,0.0
30,Broome County (West Central)--Greater Binghamton City & Greater Johnson City Village PUMA,75,29,46,23306.666666666668,24000.0,22869.565217391304,0,0,0,#DIV/0!,0.0,0.0,75,29,46,23306.666666666668,24000.0,22869.565217391304,0,0,0,#DIV/0!,0.0,0.0
31,Westchester County (Central)--White Plains City PUMA,2646,1685,961,38700.07558578987,38697.44807121662,38704.68262226847,656,294,362,61082.31707317073,55557.8231292517,65569.06077348067,1211,776,435,32306.853839801817,36485.051546391755,24853.333333333332,779,615,164,29790.500641848525,33428.9430894309,16146.341463414634
32,Nassau County (Northwest)--North Hempstead Town (North) PUMA,410,258,152,55318.34146341463,56025.27131782946,54118.42105263158,166,88,78,50537.34939759036,26534.090909090908,77617.94871794872,206,155,51,65579.22330097087,77900.12903225806,28133.333333333332,38,15,23,20578.947368421053,3000.0,32043.478260869564
33,Cattaraugus & Allegany Counties PUMA,0,0,0,#DIV/0!,0.0,0.0,0,0,0,#DIV/0!,0.0,0.0,0,0,0,#DIV/0!,0.0,0.0,0,0,0,#DIV/0!,0.0,0.0
34,NYC-Brooklyn Community District 1--Greenpoint & Williamsburg PUMA,1193,734,459,34994.92875104778,32802.38419618529,38501.08932461873,315,174,141,55457.142857142855,46304.597701149425,66751.77304964539,632,482,150,29745.09493670886,30124.066390041495,28527.333333333332,246,78,168,22280.691056910568,19232.69230769231,23695.833333333332
35,Suffolk County (Northwest)--Huntington Town (North) PUMA,1338,1045,293,26506.307922272048,25245.97129186603,31001.36518771331,143,70,73,43587.41258741259,64542.857142857145,23493.15068493151,347,214,133,27749.2795389049,21988.78504672897,37018.045112781954,848,761,87,23117.264150943396,22547.227332457293,28103.44827586207
36,"NYC-Manhattan Community District 9--Hamilton Heights, Manhattanville & West Harlem PUMA",4791,2867,1924,34721.227301189734,37380.746424834324,30758.21205821206,834,400,434,54949.16067146283,60777.75,49577.188940092165,2443,1360,1083,36235.07981989357,41190.44117647059,30012.280701754386,1514,1107,407,21135.733157199473,24246.160794941283,12675.675675675675
37,NYC-Brooklyn Community District 10--Bay Ridge & Dyker Heights PUMA,1080,801,279,32237.453703703704,31051.498127340823,35642.29390681004,162,63,99,42809.87654320987,53079.36507936508,36274.74747474748,572,392,180,30311.8006993007,28023.852040816328,35294.444444444445,346,346,0,30470.809248554913,30470.809248554913,0.0
38,"NYC-Brooklyn Community District 6--Park Slope, Carroll Gardens & Red Hook PUMA",678,183,495,46253.24483775811,50957.37704918033,44514.14141414141,270,41,229,70962.96296296296,114878.0487804878,63100.43668122271,370,133,237,30565.135135135137,33259.3984962406,29053.164556962027,38,9,29,23436.842105263157,21300.0,24100.0
39,Livingston & Wyoming Counties PUMA,42,42,0,37023.80952380953,37023.80952380953,0.0,0,0,0,#DIV/0!,0.0,0.0,9,9,0,33333.333333333336,33333.333333333336,0.0,33,33,0,38030.30303030303,38030.30303030303,0.0
40,Albany County (Outside Albany City) PUMA,32,16,16,30500.0,26000.0,35000.0,0,0,0,#DIV/0!,0.0,0.0,16,0,16,35000.0,0.0,35000.0,16,16,0,26000.0,26000.0,0.0
41,NYC-Manhattan Community District 3--Chinatown & Lower East Side PUMA,1424,763,661,37965.535112359554,41032.07339449541,34425.79425113464,382,199,183,68415.31413612566,78371.8592964824,57588.25136612022,843,482,361,25640.298932384343,24722.970954356846,26865.09695290859,199,82,117,31726.130653266333,46280.48780487805,21525.641025641027
42,Nassau County (Northeast)--Oyster Bay Town (North) & Glen Cove City PUMA,1499,1118,381,39610.340226817876,44852.32558139535,24228.346456692914,98,98,0,69290.8163265306,69290.8163265306,0.0,815,480,335,24931.16564417178,25620.625,23943.283582089553,586,540,46,55062.286689419794,57512.03703703704,26304.347826086956
43,"NYC-Queens Community District 11--Bayside, Douglaston & Little Neck PUMA",1131,885,246,54499.549071618036,38265.6384180791,112902.0325203252,267,117,150,111558.05243445693,44153.846153846156,164133.33333333334,709,613,96,38437.22143864598,39311.72920065253,32853.125,155,155,0,29683.870967741936,29683.870967741936,0.0
44,Erie County (South) PUMA,36,18,18,30361.11111111111,35722.22222222222,25000.0,18,0,18,25000.0,0.0,25000.0,18,18,0,35722.22222222222,35722.22222222222,0.0,0,0,0,#DIV/0!,0.0,0.0
45,NYC-Manhattan Community District 7--Upper West Side & West Side PUMA,773,473,300,53420.957309184996,44347.14587737843,67727.33333333333,148,62,86,70455.4054054054,93777.41935483871,53641.86046511628,378,223,155,61211.64021164021,42591.92825112108,88000.0,247,188,59,31291.497975708502,30127.659574468085,35000.0
46,"NYC-Queens Community District 12--Jamaica, Hollis & St. Albans PUMA",3445,1973,1472,30680.946298984036,32755.68170299037,27900.067934782608,532,141,391,43209.96240601504,52724.82269503546,39778.77237851662,1749,1050,699,30173.64208118925,33610.76190476191,25010.586552217454,1164,782,382,25716.89003436426,28006.9820971867,21028.795811518325
47,NYC-Brooklyn Community District 3--Bedford-Stuyvesant PUMA,1367,815,552,33321.945866861744,38689.20245398773,25397.463768115944,521,393,128,44412.092130518235,43346.81933842239,47682.8125,556,148,408,20692.446043165466,25114.864864864863,19088.235294117647,290,274,16,37611.724137931036,39340.87591240876,8000.0
48,Dutchess County (North & East) PUMA,403,348,55,36914.39205955335,35109.48275862069,48334.545454545456,7,0,7,102400.0,0.0,102400.0,203,155,48,42015.76354679803,42500.645161290326,40450.0,193,193,0,29173.575129533678,29173.575129533678,0.0
49,Oneida County (Central)--Greater Utica & Rome Cities PUMA,193,142,51,25900.518134715025,27976.056338028167,20121.56862745098,17,0,17,38882.35294117647,0.0,38882.35294117647,99,65,34,29462.62626262626,39255.38461538462,10741.176470588236,77,77,0,18454.545454545456,18454.545454545456,0.0
50,NYC-Brooklyn Community District 7--Sunset Park & Windsor Terrace PUMA,5246,3801,1445,33730.9874189859,35957.59800052618,27874.0,572,325,247,51844.405594405594,46123.07692307692,59372.46963562753,2247,1543,704,31413.809523809523,36541.542449773166,20175.042613636364,2427,1933,494,31607.305315203954,33782.32281427833,23096.55870445344
51,"NYC-Bronx Community District 1 & 2--Hunts Point, Longwood & Melrose PUMA",5587,3076,2511,34347.11294075532,35571.436931079326,32847.30386300279,1224,457,767,40941.91176470588,29705.4704595186,47636.89700130378,3393,1962,1431,34647.02033598585,40369.694189602444,26800.83857442348,970,657,313,24976.371134020617,25322.67884322679,24249.456869009584
52,Warren & Washington Counties PUMA,0,0,0,#DIV/0!,0.0,0.0,0,0,0,#DIV/0!,0.0,0.0,0,0,0,#DIV/0!,0.0,0.0,0,0,0,#DIV/0!,0.0,0.0
53,Oswego County PUMA,51,51,0,45443.13725490196,45443.13725490196,0.0,4,4,0,55000.0,55000.0,0.0,47,47,0,44629.78723404255,44629.78723404255,0.0,0,0,0,#DIV/0!,0.0,0.0
54,Erie County (Northeast) PUMA,57,57,0,64168.42105263158,64168.42105263158,0.0,28,28,0,60200.0,60200.0,0.0,29,29,0,68000.0,68000.0,0.0,0,0,0,#DIV/0!,0.0,0.0
55,Herkimer (North & Central) & Oneida (Outer) Counties PUMA,32,20,12,10875.0,12000.0,9000.0,0,0,0,#DIV/0!,0.0,0.0,12,0,12,9000.0,0.0,9000.0,20,20,0,12000.0,12000.0,0.0
56,Saratoga County (South & Central) PUMA,69,45,24,67681.15942028986,76000.0,52083.333333333336,0,0,0,#DIV/0!,0.0,0.0,69,45,24,67681.15942028986,76000.0,52083.333333333336,0,0,0,#DIV/0!,0.0,0.0
57,Columbia & Greene Counties PUMA,136,125,11,19578.676470588234,19205.6,23818.18181818182,0,0,0,#DIV/0!,0.0,0.0,105,102,3,18206.666666666668,18212.745098039217,18000.0,31,23,8,24225.8064516129,23608.695652173912,26000.0
58,"NYC-Queens Community District 8--Briarwood, Fresh Meadows & Hillcrest PUMA",2937,1664,1273,42596.68028600613,42544.921875,42664.3362136685,1040,509,531,52905.192307692305,63074.656188605106,43157.062146892655,1361,759,602,37926.70830271859,32959.35441370224,44189.53488372093,536,396,140,34452.985074626864,34529.292929292926,34237.142857142855
59,NYC-Queens Community District 6--Forest Hills & Rego Park PUMA,800,508,292,53409.0625,43671.35826771653,70350.0,260,164,96,73443.65384615384,45825.30487804878,120625.0,509,313,196,45049.31237721022,44625.8785942492,45725.510204081635,31,31,0,22638.709677419356,22638.709677419356,0.0
60,NYC-Queens Community District 10--Howard Beach & Ozone Park PUMA,2467,1398,1069,39456.82205107418,41323.090128755364,37016.18334892423,475,182,293,56096.16842105263,62600.98901098901,52055.631399317404,1547,869,678,37080.67226890756,40169.8504027618,33121.238938053095,445,347,98,29956.1797752809,33051.00864553314,18997.95918367347
61,Erie County (North Central) PUMA,60,0,60,86050.0,0.0,86050.0,30,0,30,130000.0,0.0,130000.0,30,0,30,42100.0,0.0,42100.0,0,0,0,#DIV/0!,0.0,0.0
62,NYC-Brooklyn Community District 16--Brownsville & Ocean Hill PUMA,1760,903,857,38429.318181818184,40111.40642303433,36656.94282380397,178,67,111,47484.831460674155,39189.55223880597,52491.89189189189,997,444,553,47173.420260782346,54996.62162162162,40892.22423146474,585,392,193,20771.62393162393,23409.183673469386,15414.507772020725
63,NYC-Staten Island Community District 2--New Springville & South Beach PUMA,453,334,119,31587.417218543047,35107.18562874252,21708.40336134454,51,18,33,25135.29411764706,67000.0,2300.0,303,263,40,33799.3399339934,33953.61216730038,32785.0,99,53,46,28141.41414141414,30000.0,26000.0
64,Madison & Cortland Counties PUMA,33,0,33,40090.90909090909,0.0,40090.90909090909,7,0,7,85000.0,0.0,85000.0,26,0,26,28000.0,0.0,28000.0,0,0,0,#DIV/0!,0.0,0.0
65,Westchester County (Northwest) PUMA,4172,3073,1099,29365.215723873443,29868.369671330947,27958.30755232029,605,304,301,40769.71900826446,45307.89473684211,36186.3122923588,2670,2093,577,29063.520599250936,29725.60917343526,26661.871750433274,897,676,221,22571.23745819398,23367.159763313608,20136.65158371041
66,NYC-Brooklyn Community District 4--Bushwick PUMA,4195,2804,1391,35930.11108462455,35927.131241084164,35936.1179007908,725,372,353,56435.36551724138,42703.22580645161,70906.62889518414,2614,1775,839,32782.661055853096,36231.98647887324,25485.220500595948,856,657,199,28174.415887850468,31266.818873668188,17964.824120603014
67,"Rockland County (South)--Orangetown, Clarkstown (South) & Ramapo (Southeast) Towns PUMA",620,407,213,57348.3870967742,52125.307125307125,67328.63849765259,224,73,151,85758.92857142857,82739.72602739726,87218.54304635762,302,240,62,45877.48344370861,52850.0,18887.09677419355,94,94,0,26500.0,26500.0,0.0
68,"NYC-Manhattan Community District 12--Washington Heights, Inwood & Marble Hill PUMA",12333,6509,5824,34329.25216897754,37366.93654939315,30934.285199175825,2580,1075,1505,44388.13953488372,57915.90697674418,34725.44850498339,7677,4017,3660,33515.913377621466,36190.51282051282,30580.43087431694,2076,1417,659,24836.030828516377,25112.561750176428,24241.426403641883
69,NYC-Brooklyn Community District 2--Brooklyn Heights & Fort Greene PUMA,978,549,429,38954.24335378323,35845.719489981784,42932.28438228438,316,195,121,55784.65189873418,45271.794871794875,72726.85950413223,536,288,248,33559.888059701494,31948.958333333332,35430.645161290326,126,66,60,19692.06349206349,25000.0,13853.333333333334
70,"NYC-Queens Community District 14--Far Rockaway, Breezy Point & Broad Channel PUMA",692,457,235,53443.78612716763,62572.210065645515,35691.914893617024,137,60,77,100635.03649635037,163400.0,51727.27272727273,251,125,126,43601.59362549801,64040.0,23325.396825396827,304,272,32,40302.96052631579,39656.25,45800.0
71,Suffolk County (Central)--Islip Town (East) PUMA,110,86,24,49541.09090909091,53223.25581395349,36346.666666666664,16,0,16,39020.0,0.0,39020.0,78,70,8,56733.333333333336,59674.28571428572,31000.0,16,16,0,25000.0,25000.0,0.0
72,NYC-Brooklyn Community District 14--Flatbush & Midwood PUMA,2123,1163,960,32500.04710315591,34024.591573516765,30653.125,272,152,120,59069.48529411765,48180.92105263158,72861.66666666667,1138,569,569,29160.105448154656,34823.1985940246,23497.01230228471,713,442,271,27694.950911640954,28128.280542986424,26988.191881918818
73,"NYC-Bronx Community District 4--Concourse, Highbridge & Mount Eden PUMA",6717,3676,3041,36656.88253684681,37439.44504896627,35710.91088457744,1337,611,726,49588.706058339565,54600.163666121116,45371.074380165286,4399,2518,1881,35526.61968629234,35319.698173153294,35803.61509835194,981,547,434,24100.489296636086,28028.702010968922,19149.493087557603
74,Erie County (West Central)--Buffalo City (East) PUMA,124,73,51,23071.774193548386,19657.534246575342,27958.823529411766,9,0,9,37100.0,0.0,37100.0,77,35,42,26116.883116883117,26257.14285714286,26000.0,38,38,0,13578.947368421053,13578.947368421053,0.0
75,Nassau County (East Central)--Oyster Bay Town (Central) PUMA,325,199,126,54592.92307692308,62576.38190954774,41984.12698412698,89,32,57,62615.730337078654,92306.25,45947.36842105263,127,77,50,45354.330708661415,54181.818181818184,31760.0,109,90,19,58806.422018348625,59187.77777777778,57000.0
76,Niagara County (Southwest)--Greater Niagara Falls & North Tonawanda Area PUMA,90,60,30,17577.777777777777,21816.666666666668,9100.0,30,0,30,9100.0,0.0,9100.0,60,60,0,21816.666666666668,21816.666666666668,0.0,0,0,0,#DIV/0!,0.0,0.0
77,"NYC-Manhattan Community District 6--Murray Hill, Gramercy & Stuyvesant Town PUMA",275,34,241,96704.72727272728,300000.0,68024.0663900415,214,34,180,105284.11214953271,300000.0,68504.44444444444,61,0,61,66606.55737704918,0.0,66606.55737704918,0,0,0,#DIV/0!,0.0,0.0
78,Jefferson & Lewis Counties PUMA,226,138,88,19021.681415929204,14582.608695652174,25982.954545454544,35,0,35,40342.857142857145,0.0,40342.857142857145,101,48,53,10939.60396039604,4800.0,16500.0,90,90,0,19800.0,19800.0,0.0
79,Fulton & Montgomery Counties PUMA,160,138,22,22378.125,20206.521739130436,36000.0,0,0,0,#DIV/0!,0.0,0.0,106,84,22,22830.188679245282,19380.95238095238,36000.0,54,54,0,21490.74074074074,21490.74074074074,0.0
80,"NYC-Bronx Community District 8--Riverdale, Fieldston & Kingsbridge PUMA",5121,2909,2212,42519.90236281976,42646.57958061189,42353.309222423144,1469,653,816,55480.91218515997,65731.08728943339,47278.259803921566,2766,1499,1267,41493.29718004338,41948.498999332885,40954.74348855564,886,757,129,24235.32731376975,24115.85204755614,24936.434108527134
81,NYC-Brooklyn Community District 8--Crown Heights North & Prospect Heights PUMA,968,235,733,45480.061983471074,21195.744680851065,53265.620736698496,347,18,329,76552.44956772335,50000.0,78005.16717325228,515,129,386,31573.59223300971,22914.728682170542,34467.35751295337,106,88,18,11326.415094339623,12784.09090909091,4200.0
82,NYC-Queens Community District 3--Jackson Heights & North Corona PUMA,10760,7460,3300,31416.689498141262,32214.45871313673,29613.247575757574,1074,598,476,44582.78584729981,48690.48829431438,39422.268907563026,7162,4782,2380,30627.94847807875,31455.510246758677,28965.175210084035,2524,2080,444,28052.41679873217,29222.451923076922,22571.171171171172
83,Monroe County (North & West) PUMA,86,52,34,35421.86046511628,40038.46153846154,28361.176470588234,21,21,0,77000.0,77000.0,0.0,34,0,34,28361.176470588234,0.0,28361.176470588234,31,31,0,15000.0,15000.0,0.0
84,NYC-Brooklyn Community District 5--East New York & Starrett City PUMA,3163,1756,1407,36931.35314574771,38462.1867881549,35020.803127221036,492,252,240,65876.56504065041,66775.79365079365,64932.375,1964,1072,892,34796.9450101833,36627.14552238806,32597.421524663678,707,432,275,22717.680339462517,26499.537037037036,16776.727272727272
85,"Steuben (North & West), Schuyler & Chemung (North) Counties PUMA",0,0,0,#DIV/0!,0.0,0.0,0,0,0,#DIV/0!,0.0,0.0,0,0,0,#DIV/0!,0.0,0.0,0,0,0,#DIV/0!,0.0,0.0
86,NYC-Brooklyn Community District 13--Brighton Beach & Coney Island PUMA,402,196,206,43147.76119402985,45047.95918367347,41339.80582524272,64,36,28,56146.875,64816.666666666664,45000.0,210,61,149,44213.333333333336,76049.18032786885,31179.86577181208,128,99,29,34900.0,18757.575757575756,90006.89655172414
87,NYC-Manhattan Community District 8--Upper East Side PUMA,882,538,344,76925.54421768707,91874.21933085502,53546.51162790698,424,113,311,89887.57075471699,187410.0,54453.37620578778,373,340,33,68327.07774798927,70591.17647058824,45000.0,85,85,0,50000.0,50000.0,0.0
88,"Chenango, Delaware & Broome (East) Counties PUMA",82,73,9,28448.780487804877,29983.561643835616,16000.0,2,2,0,22900.0,22900.0,0.0,80,71,9,28587.5,30183.098591549297,16000.0,0,0,0,#DIV/0!,0.0,0.0
89,"NYC-Queens Community District 5--Ridgewood, Glendale & Middle Village PUMA",1844,1126,718,42651.200650759216,43899.644760213145,40693.33426183844,361,197,164,70641.55124653739,71888.32487309644,69143.90243902439,1171,650,521,34912.39453458582,37057.230769230766,32236.49520153551,312,279,33,39310.256410256414,40078.13620071684,32818.181818181816
90,NYC-Brooklyn Community District 18--Canarsie & Flatlands PUMA,1418,769,649,43398.77997179126,37792.32769830949,50041.86440677966,473,149,324,54727.27272727273,53448.32214765101,55315.432098765436,743,434,309,40278.156123822344,36786.40552995392,45182.42718446602,202,186,16,28350.49504950495,27597.84946236559,37100.0
91,Monroe County (Central)--Rochester City (West) PUMA,198,54,144,28488.88888888889,35298.148148148146,25935.416666666668,0,0,0,#DIV/0!,0.0,0.0,166,54,112,30125.301204819276,35298.148148148146,27631.25,32,0,32,20000.0,0.0,20000.0
92,Erie County (Northwest) PUMA,26,26,0,37800.0,37800.0,0.0,0,0,0,#DIV/0!,0.0,0.0,26,26,0,37800.0,37800.0,0.0,0,0,0,#DIV/0!,0.0,0.0
93,NYC-Queens Community District 4--Elmhurst & South Corona PUMA,6361,4740,1621,32039.251689985853,32978.350210970464,29293.214065391734,638,408,230,44106.11285266458,45592.401960784315,41469.565217391304,4153,3039,1114,31509.241512159886,32814.57058242843,27948.294434470376,1570,1293,277,28537.64331210191,29382.985305491107,24591.696750902527
94,"Otsego, Schoharie, Oneida (South) & Herkimer (South) Counties PUMA",110,85,25,28900.363636363636,23812.235294117647,46200.0,25,0,25,46200.0,0.0,46200.0,6,6,0,32000.0,32000.0,0.0,79,79,0,23190.379746835442,23190.379746835442,0.0
95,Suffolk County (Central)--Islip Town (Northwest) PUMA,4132,2736,1396,41530.324298160696,45462.09795321638,33824.49856733524,563,428,135,46438.721136767315,51518.69158878505,30333.333333333332,2459,1533,926,41592.842618950795,44916.373124592305,36090.71274298056,1110,775,335,38902.252252252256,43196.77419354839,28967.16417910448
96,Rensselaer County--Troy City PUMA,146,91,55,35979.45205479452,39681.318681318684,29854.545454545456,61,61,0,43950.81967213115,43950.81967213115,0.0,55,0,55,29854.545454545456,0.0,29854.545454545456,30,30,0,31000.0,31000.0,0.0
97,"NYC-Queens Community District 13--Queens Village, Cambria Heights & Rosedale PUMA",1756,993,763,51864.567198177676,55875.32729103726,46644.79685452163,557,291,266,65084.91921005386,67806.87285223368,62107.142857142855,1030,583,447,48131.922330097084,54110.463121783876,40334.407158836686,169,119,50,31041.420118343194,35344.53781512605,20800.0
98,Erie County (West Central)--Buffalo City (West) PUMA,363,193,170,41161.707988980714,38504.145077720204,44178.82352941176,187,153,34,39450.26737967914,37972.549019607846,46100.0,149,40,109,47144.29530201342,40537.5,49568.807339449544,27,0,27,20000.0,0.0,20000.0
99,Suffolk County (Central)--Brookhaven Town (Central) PUMA,819,616,203,46787.54578754579,46305.194805194806,48251.231527093594,107,84,23,60420.56074766355,61630.95238095238,56000.0,471,371,100,53473.673036093416,49748.24797843666,67295.0,241,161,80,27667.634854771783,30375.155279503106,22218.75
100,Cayuga & Onondaga (South) Counties PUMA,137,137,0,34014.598540145984,34014.598540145984,0.0,8,8,0,91000.0,91000.0,0.0,87,87,0,31678.16091954023,31678.16091954023,0.0,42,42,0,28000.0,28000.0,0.0
101,Sullivan & Ulster (West) Counties PUMA,283,158,125,31887.27915194346,29279.74683544304,35183.2,34,0,34,36911.76470588235,0.0,36911.76470588235,227,136,91,29555.506607929514,26222.058823529413,34537.36263736264,22,22,0,48181.818181818184,48181.818181818184,0.0
102,Chemung (South) & Steuben (East) Counties--Greater Elmira & Greater Corning Cities PUMA,47,23,24,38595.744680851065,58000.0,20000.0,0,0,0,#DIV/0!,0.0,0.0,47,23,24,38595.744680851065,58000.0,20000.0,0,0,0,#DIV/0!,0.0,0.0
103,"NYC-Brooklyn Community District 17--East Flatbush, Farragut & Rugby PUMA",1052,437,615,42776.80608365019,46963.38672768879,39801.95121951219,347,144,203,59348.70317002882,63055.555555555555,56719.2118226601,578,229,349,35565.74394463668,42186.89956331878,31221.203438395416,127,64,63,30316.535433070865,27846.875,32825.39682539683
104,Rockland County (North)--New City & Congers PUMA,1381,896,485,38504.98913830557,37595.41294642857,40185.36082474227,166,90,76,89334.27710843373,125483.22222222222,46526.31578947369,768,446,322,36236.067708333336,29191.479820627803,45993.47826086957,447,360,87,23527.069351230424,26035.0,13149.425287356322
105,Saratoga County (Outer) PUMA,0,0,0,#DIV/0!,0.0,0.0,0,0,0,#DIV/0!,0.0,0.0,0,0,0,#DIV/0!,0.0,0.0,0,0,0,#DIV/0!,0.0,0.0
106,Nassau County (Central)--Hempstead Town (North Central)--Meadowbrook Corridor PUMA,4210,2849,1361,36486.733966745844,40490.628290628294,28105.326965466567,324,181,143,48862.345679012345,45287.29281767956,53387.41258741259,2531,1484,1047,34853.79296720664,42671.832884097035,23772.63610315186,1355,1184,171,36577.71217712177,37023.47972972973,33491.228070175435
107,Putnam County PUMA,564,419,145,54504.255319148935,56543.19809069212,48612.41379310345,127,26,101,53181.10236220472,35000.0,57861.38613861386,330,286,44,62001.818181818184,67327.97202797203,27381.81818181818,107,107,0,32951.40186915888,32951.40186915888,0.0
108,NYC-Brooklyn Community District 11--Bensonhurst & Bath Beach PUMA,1786,1443,343,32139.753639417693,31999.3762993763,32730.320699708456,285,176,109,29428.070175438595,24784.090909090908,36926.605504587154,1015,833,182,35563.74384236453,36005.882352941175,33540.10989010989,486,434,52,26579.012345679013,27235.483870967742,21100.0
109,Orange County (Southeast) PUMA,717,430,287,81159.27475592747,54391.16279069767,121264.80836236934,287,91,196,120961.6724738676,59527.47252747253,149484.693877551,342,251,91,60995.3216374269,61180.876494023905,60483.51648351648,88,88,0,29713.636363636364,29713.636363636364,0.0
110,Onondaga County (Central)--Syracuse City (Outer) PUMA,135,61,74,52117.03703703704,58360.65573770492,46970.27027027027,68,29,39,78129.41176470589,84310.3448275862,73533.33333333333,48,13,35,18083.333333333332,20000.0,17371.428571428572,19,19,0,45000.0,45000.0,0.0
111,"Rockland County (West)--Spring Valley, Suffern Villages & Monsey PUMA",1527,1132,395,28441.912246234446,25957.68551236749,35561.26582278481,163,140,23,50993.865030674846,51814.28571428572,46000.0,714,447,267,31746.358543417366,25885.234899328858,41558.80149812734,650,545,105,19156.76923076923,19375.045871559632,18023.809523809523
112,Monroe County (East) PUMA,67,67,0,54246.26865671642,54246.26865671642,0.0,0,0,0,#DIV/0!,0.0,0.0,67,67,0,54246.26865671642,54246.26865671642,0.0,0,0,0,#DIV/0!,0.0,0.0
113,NYC-Manhattan Community District 10--Central Harlem PUMA,1512,611,901,36207.94312169312,38221.53846153846,34842.45283018868,613,183,430,44771.94127243067,50693.98907103825,42251.62790697674,762,340,422,29592.139107611547,29863.41176470588,29373.578199052132,137,88,49,34686.131386861314,44577.27272727273,16922.448979591838
114,Nassau County (Southwest)--Hempstead Town (Southwest) & Long Beach City PUMA,1004,735,269,40091.53386454183,40624.489795918365,38635.31598513011,137,73,64,86667.15328467153,80136.98630136986,94115.625,594,468,126,36414.98316498317,41803.418803418805,16400.79365079365,273,194,79,24717.94871794872,22912.371134020617,29151.898734177215
115,Nassau County (Southeast)--Oyster Bay Town (South) PUMA,264,141,123,73701.89393939394,80420.56737588653,66000.0,99,21,78,142111.11111111112,340000.0,88833.33333333333,120,75,45,29265.0,30970.666666666668,26422.222222222223,45,45,0,41700.0,41700.0,0.0
116,Wayne & Seneca Counties PUMA,66,66,0,124333.33333333333,124333.33333333333,0.0,64,64,0,126656.25,126656.25,0.0,0,0,0,#DIV/0!,0.0,0.0,2,2,0,50000.0,50000.0,0.0
117,Schenectady County--Schenectady City PUMA,104,47,57,41961.53846153846,34638.29787234042,48000.0,57,0,57,48000.0,0.0,48000.0,27,27,0,24000.0,24000.0,0.0,20,20,0,49000.0,49000.0,0.0
118,"NYC-Brooklyn Community District 9--Crown Heights South, Prospect Lefferts & Wingate PUMA",936,587,349,41580.982905982906,43689.608177172064,38034.38395415473,160,19,141,51806.25,180000.0,34531.914893617024,622,414,208,43094.53376205788,44443.961352657,40408.653846153844,154,154,0,24844.155844155845,24844.155844155845,0.0
119,"NYC-Manhattan Community District 4 & 5--Chelsea, Clinton & Midtown Business District PUMA",879,366,513,46969.35153583618,41475.956284153006,50888.61598440546,161,74,87,109881.98757763975,92108.1081081081,125000.0,386,149,237,38136.94300518135,38182.55033557047,38108.27004219409,332,143,189,26729.518072289156,18706.293706293705,32800.0
120,Westchester County (Northeast) PUMA,1841,1342,499,32632.265073329712,30120.491803278688,39387.374749498995,271,119,152,53101.845018450185,56559.663865546216,50394.73684210526,841,527,314,34369.56004756242,34592.97912713473,33994.58598726115,729,696,33,23018.655692729768,22213.505747126437,40000.0
121,Nassau County (South Central)--Hempstead Town (Southeast) PUMA,1303,685,618,51715.27244819647,58723.357664233576,43947.411003236244,324,163,161,93316.97530864198,128820.24539877301,57372.67080745342,682,323,359,40543.69501466276,36751.70278637771,43955.431754874655,297,199,98,31984.848484848484,36969.849246231155,21862.244897959183
122,NYC-Queens Community District 2--Sunnyside & Woodside PUMA,2357,1484,873,33442.24862112855,33123.76010781671,33983.64261168385,533,251,282,43336.960600375234,46231.87250996016,40760.283687943265,1315,863,452,32185.64258555133,31245.654692931636,33980.35398230088,509,370,139,26327.426326129666,28612.054054054053,20246.043165467625
123,"NYC-Staten Island Community District 3--Tottenville, Great Kills & Annadale PUMA",364,328,36,39504.945054945056,41695.12195121951,19550.0,75,75,0,65000.0,65000.0,0.0,219,201,18,35054.79452054795,34791.0447761194,38000.0,70,52,18,26111.428571428572,34769.230769230766,1100.0
124,Suffolk County (Central)--Brookhaven Town (West Central) PUMA,344,249,95,50945.348837209305,51161.44578313253,50378.94736842105,63,52,11,94603.1746031746,92403.84615384616,105000.0,161,97,64,49217.391304347824,50443.298969072166,47359.375,120,100,20,30343.333333333332,30412.0,30000.0
125,NYC-Queens Community District 9--Richmond Hill & Woodhaven PUMA,4985,3061,1924,45035.52557673019,46842.997386475006,42159.91683991684,1362,775,587,52218.13142437592,60791.116129032256,40899.45485519591,3034,1814,1220,43609.063941990775,43250.551267916206,44142.13114754098,589,472,117,35774.36332767402,37747.457627118645,27814.529914529914
126,Suffolk County (Northwest)--Huntington Town (South) PUMA,125,36,89,45584.0,58694.444444444445,40280.89887640449,45,17,28,62111.11111111111,55000.0,66428.57142857143,80,19,61,36287.5,62000.0,28278.688524590165,0,0,0,#DIV/0!,0.0,0.0
127,"NYC-Bronx Community District 3 & 6--Belmont, Crotona Park East & East Tremont PUMA",6296,3740,2556,33957.57623888183,34324.11229946524,33421.251956181535,1483,811,672,42807.13418745786,44118.10110974106,41225.0,3728,2191,1537,32664.43669527897,33068.09675947056,32089.017566688355,1085,738,347,26304.976958525345,27290.243902439026,24209.51008645533
128,Suffolk County (North Central)--Brookhaven Town (North) PUMA,127,73,54,38787.40157480315,18657.534246575342,66000.0,54,0,54,66000.0,0.0,66000.0,30,30,0,11000.0,11000.0,0.0,43,43,0,24000.0,24000.0,0.0
129,NYC-Queens Community District 1--Astoria & Long Island City PUMA,3242,2245,997,35766.77359654534,38032.8285077951,30664.17251755266,829,539,290,44427.74427020507,47067.161410018554,39522.06896551724,1695,1099,596,31434.678466076697,33185.2593266606,28206.677852348992,718,607,111,35993.732590529245,38787.31466227348,20717.117117117115
130,Nassau County (West Central)--Hempstead Town (Northwest) PUMA,1672,917,755,53554.78468899521,56086.150490730644,50480.26490066225,206,69,137,81540.77669902913,101246.37681159421,71616.05839416059,1352,808,544,49131.80473372781,51689.35643564357,45333.08823529412,114,40,74,55438.59649122807,67000.0,49189.18918918919
131,Westchester County (Southeast) PUMA,3230,2149,1081,37546.13003095975,40987.994416007445,30703.792784458834,515,318,197,49682.71844660194,59872.955974842764,33233.502538071065,1873,1050,823,36063.26748531767,40441.04761904762,30478.007290400972,842,781,61,33421.49643705463,34033.93085787452,25580.32786885246
132,"NYC-Bronx Community District 10--Co-op City, Pelham Bay & Schuylerville PUMA",2014,992,1022,58372.586891757695,67907.75201612903,49117.31898238748,639,124,515,62036.76056338028,65424.91935483871,61220.970873786406,1166,723,443,62118.782161234994,75544.95159059475,40206.546275395034,209,145,64,26269.856459330145,31950.344827586207,13400.0
133,Suffolk County (South Central)--Brookhaven Town (South) PUMA,515,236,279,36661.35922330097,24543.22033898305,46911.82795698925,163,17,146,60429.447852760735,50000.0,61643.83561643836,317,184,133,27527.44479495268,25205.434782608696,30739.84962406015,35,35,0,8697.142857142857,8697.142857142857,0.0
134,Onondaga County (Central)--Syracuse City PUMA,260,179,81,27708.846153846152,23649.72067039106,36679.01234567901,86,76,10,36937.20930232558,36231.57894736842,42300.0,149,78,71,23273.154362416106,11791.02564102564,35887.32394366197,25,25,0,22400.0,22400.0,0.0
135,Suffolk County (West Central)--Babylon Town (Northwest) PUMA,1771,1304,467,49165.72557876906,54995.552147239265,32887.15203426124,126,34,92,77079.36507936507,79117.64705882352,76326.08695652174,1133,848,285,47183.49514563107,55738.91509433962,21727.36842105263,512,422,90,46682.8125,51558.29383886256,23822.222222222223
136,Suffolk County (Southwest)--Islip Town (South) PUMA,1042,746,296,42754.510556621884,44160.32171581769,39211.48648648649,238,180,58,63373.94957983193,58533.333333333336,78396.55172413793,436,363,73,47642.88990825688,48956.74931129476,41109.58904109589,368,203,165,23627.445652173912,22838.916256157634,24597.575757575756
137,Niagara County (North & East) PUMA,0,0,0,#DIV/0!,0.0,0.0,0,0,0,#DIV/0!,0.0,0.0,0,0,0,#DIV/0!,0.0,0.0,0,0,0,#DIV/0!,0.0,0.0
138,NYC-Manhattan Community District 11--East Harlem PUMA,2663,1570,1093,37874.78032294405,28406.07643312102,51475.75480329369,531,83,448,53710.056497175145,41294.4578313253,56010.267857142855,1491,985,506,38278.13547954393,28254.111675126904,57791.30434782609,641,502,139,23818.720748829954,26573.306772908367,13870.503597122302
139,Broome (Outer West) & Tioga Counties PUMA,84,0,84,35000.0,0.0,35000.0,84,0,84,35000.0,0.0,35000.0,0,0,0,#DIV/0!,0.0,0.0,0,0,0,#DIV/0!,0.0,0.0
140,Albany County (East Central)--Albany City PUMA,68,17,51,44750.0,35000.0,48000.0,17,17,0,35000.0,35000.0,0.0,51,0,51,48000.0,0.0,48000.0,0,0,0,#DIV/0!,0.0,0.0
141,Nassau County (West Central)--Hempstead Town (West Central) PUMA,1912,1044,868,47105.77928870293,43269.204980842915,51720.27649769585,240,71,169,97772.91666666667,103633.80281690141,95310.65088757397,1437,765,672,41770.18093249826,42069.34640522876,41429.61309523809,235,208,27,27987.23404255319,27076.923076923078,35000.0
142,Nassau County (West Central)--North Hempstead Town (South) PUMA,1736,1080,656,42254.14746543779,43978.7962962963,39414.78658536585,438,192,246,71004.56621004567,88255.20833333333,57540.650406504064,808,549,259,32602.227722772277,35264.48087431694,26959.073359073358,490,339,151,32470.61224489796,33014.45427728614,31249.668874172185
143,Nassau County (Central)--Hempstead Town (Northeast) PUMA,1424,1069,355,46506.60112359551,47139.75678203929,44600.0,90,15,75,46788.88888888889,120000.0,32146.666666666668,920,640,280,48377.608695652176,48570.9375,47935.71428571428,414,414,0,42287.43961352657,42287.43961352657,0.0
144,Nassau County (Central)--Hempstead Town (East Central) PUMA,269,138,131,72708.55018587361,78771.01449275362,66322.13740458015,96,96,0,95947.91666666667,95947.91666666667,0.0,156,25,131,64347.4358974359,54000.0,66322.13740458015,17,17,0,18200.0,18200.0,0.0
145,"NYC-Bronx Community District 5--Morris Heights, Fordham South & Mount Hope PUMA",6315,3478,2837,32285.479018210608,34083.55376653249,30081.14205146281,1662,820,842,37300.60168471721,39166.09756097561,35483.84798099763,3530,1992,1538,32061.076487252125,34337.399598393575,29112.808842652797,1123,666,457,25568.6553873553,27066.516516516516,23385.77680525164
146,Capital Region,555,341,214,240450.82640721108,230525.21655365912,236756.0606060606,135,78,57,126950.81967213115,78950.81967213115,48000.0,323,174,149,222742.37154150198,118212.74509803922,182937.87878787878,97,89,8,130225.80645161291,129608.69565217392,26000.0
147,Central NY,760,498,262,263753.0002990624,212239.5407745725,200990.19170685837,264,134,130,422896.29139670177,341541.92377495463,278083.3333333333,410,278,132,188664.43584933222,151098.97379460844,81258.75251509054,86,86,0,95400.0,95400.0,0.0
148,Finger Lakes,1209,745,464,486963.4538185307,438220.804146079,377544.58193273743,326,168,158,360721.72483497055,323939.10714285716,157907.99307273625,604,343,261,352827.9591370467,217137.9473910772,432389.01737967914,279,234,45,225868.6234936235,189868.6234936235,36000.0
149,Long Island,28326,18360,9966,1175690.6959850118,1207575.0218686832,1107831.9708875075,4035,2087,1948,1778033.752775031,2044225.03325236,1495444.2468625922,16500,10148,6352,1009137.374869367,1038498.637023617,871109.7005496941,7791,6125,1666,790254.0500791414,798722.872540665,523251.2162873943
150,Mid-Hudson,28990,19680,9310,719996.9080068568,690900.1250053284,775570.9216409837,5407,2639,2768,1185478.0707425496,982148.4336411826,1114866.9244159702,16056,10647,5409,651558.5831496676,672757.0106859938,576156.9877530192,7527,6394,1133,532053.9415667515,552375.3167290152,213859.09268320288
151,Mohawk Valley,495,385,110,88054.00677107865,83994.81337127625,111321.56862745098,42,0,42,85082.35294117648,0.0,85082.35294117648,223,155,68,93292.81494187155,90636.33699633699,55741.17647058824,230,230,0,75135.66594212165,75135.66594212165,0.0
152,New York City,154799,93296,61503,2317372.0201505832,2570697.17877931,2195003.1704715802,31865,14563,17302,3192435.3700583717,3728460.8338104403,2975288.5581612107,90382,54710,35672,2093766.8503582566,2137109.8560410882,1906812.6388987585,32552,24023,8529,1561251.4255222853,1597578.5377213936,1118733.3662728271
153,North Country,410,249,161,179186.32856307633,234080.2277432712,100277.60971786834,85,42,43,363074.0,332500.0,119104.10714285714,194,76,118,79003.7065244986,21585.714285714286,80800.0,131,131,0,94466.66666666667,94466.66666666667,0.0
154,Southern Tier,342,179,163,182462.30294643372,169094.67275494672,93869.5652173913,86,2,84,57900.0,22900.0,35000.0,254,175,79,148836.0651936716,170529.25243770314,58869.565217391304,2,2,0,25000.0,25000.0,0.0
155,Western NY,880,541,339,358256.283577041,277070.72623852076,204787.64705882355,314,193,121,340000.26737967914,137322.54901960783,247300.0,430,239,191,322400.0673077854,280233.5317460317,130168.80733944954,136,109,27,100464.05375139978,80464.05375139978,20000.0
