,puma,Total_geo,Total_geo_m,Total_geo_f,Total_Avg_PINCP_mf_t,Total_Avg_PINCP_m,Total_Avg_PINCP_f,Total_BABS,Total_BABS_m,Total_BABS_f,BABS_Avg_PINCP_mf_t,BABS_Avg_PINCP_m,BABS_Avg_PINCP_f,Total_HS,Total_HS_m,Total_HS_f,HS_Avg_PINCP_mf_t,HS_Avg_PINCP_m,HS_Avg_PINCP_f,Total_HSINC,Total_HSINC_m,Total_HSINC_f,HSINC_Avg_PINCP_mf_t,HSINC_Avg_PINCP_m,HSINC_Avg_PINCP_f
0,Total Geo,1080418,626435,453983,61124.85226273535,64943.59795828777,55855.50085575892,482420,255865,226555,86991.88439326728,97573.51014011295,75041.28665004083,470840,280640,190200,42048.86111842664,44652.22860960662,38207.59375394322,127158,89930,37228,33623.366158637284,35428.61312131658,29262.512517459978
1,"NYC-Manhattan Community District 6--Murray Hill, Gramercy & Stuyvesant Town PUMA",6276,2137,4139,152058.07202039516,215957.61347683668,119066.20922928244,5778,2137,3641,158669.3423329872,215957.61347683668,125045.32820653667,498,0,498,75351.40562248995,0.0,75351.40562248995,0,0,0,#DIV/0!,0.0,0.0
2,Tompkins County PUMA,2633,1464,1169,78176.9084694265,117790.91530054645,28566.210436270318,2282,1113,1169,80100.48203330411,134227.67295597485,28566.210436270318,351,351,0,65670.94017094017,65670.94017094017,0.0,0,0,0,#DIV/0!,0.0,0.0
3,Westchester County (South Central)--New Rochelle & Mount Vernon Cities PUMA,12593,7575,5018,72910.11355514968,81261.76369636964,60302.75009964129,3567,1814,1753,146347.29464536023,190208.37927232636,100959.95436394752,7149,4708,2441,48101.56245628759,51214.033559898045,42098.4842277755,1877,1053,824,27841.337240277036,27924.20702754036,27735.436893203885
4,"NYC-Queens Community District 7--Flushing, Murray Hill & Whitestone PUMA",31932,18785,13147,52789.46229487661,57504.28373702422,46052.72229405948,12349,7223,5126,67002.37104218965,74855.75245742766,55936.24268435427,17029,9935,7094,45016.03206295144,47771.38097634625,41157.22300535664,2554,1627,927,35897.736883320285,39905.470190534725,28863.667745415318
5,Madison & Cortland Counties PUMA,465,212,253,139938.27956989247,279199.5283018868,23245.059288537548,297,173,124,213173.40067340067,341419.0751445087,34250.0,168,39,129,10469.047619047618,3200.0,12666.666666666666,0,0,0,#DIV/0!,0.0,0.0
6,NYC-Brooklyn Community District 5--East New York & Starrett City PUMA,10287,5307,4980,37238.531155827746,39750.89504428114,34561.198795180724,1829,646,1183,61384.62001093494,79519.19504643962,51481.88503803888,6656,3324,3332,32438.807091346152,34706.0770156438,30176.98079231693,1802,1337,465,30459.267480577135,33078.23485415109,22929.032258064515
7,Dutchess County (Southwest) PUMA,5716,3443,2273,80577.14135759273,76848.99215800174,86224.31148262208,3385,1524,1861,114439.04283604136,136891.99475065616,96051.99355185384,1740,1328,412,35243.9540229885,33199.8343373494,41832.76699029126,591,591,0,20098.646362098138,20098.646362098138,0.0
8,"NYC-Bronx Community District 3 & 6--Belmont, Crotona Park East & East Tremont PUMA",11414,6557,4857,35455.12440862099,34487.81302424889,36761.004735433395,2121,708,1413,41596.039603960395,44326.27118644068,40228.02547770701,8090,4966,3124,36038.29295426452,35585.741039065644,36757.682458386684,1203,883,320,20706.400665004156,20424.462061155155,21484.375
9,Dutchess County (North & East) PUMA,3457,1699,1758,50282.68440844663,56300.7651559741,44466.575654152446,759,247,512,72956.52173913043,92995.95141700405,63289.0625,2123,1105,1018,47567.78144135657,56786.42533936651,37561.29666011788,575,347,228,30377.11304347826,28634.00576368876,33030.0
10,Erie County (Central) PUMA,2371,1298,1073,42863.44580345845,44469.56086286595,40920.54054054054,899,425,474,57886.75194660734,61357.529411764706,54774.76793248945,1345,811,534,33597.799256505576,35196.72009864365,31169.475655430713,127,62,65,34645.669291338585,50000.0,20000.0
11,Suffolk County (West Central)--Babylon Town (Northwest) PUMA,6751,3701,3050,58020.04591912309,60383.87733045123,55151.67213114754,1984,598,1386,75819.50604838709,94898.49498327759,67587.73448773449,3648,2283,1365,50997.568530701756,53884.419623302674,46169.230769230766,1119,820,299,49355.049151027706,53308.90243902439,38511.70568561873
12,"Otsego, Schoharie, Oneida (South) & Herkimer (South) Counties PUMA",458,227,231,146700.78602620086,52687.48898678414,239086.1471861472,195,83,112,290758.46153846156,73518.07228915663,451749.10714285716,47,36,11,41229.78723404255,21133.333333333332,107000.0,216,108,108,39598.42592592593,47196.851851851854,32000.0
13,NYC-Brooklyn Community District 7--Sunset Park & Windsor Terrace PUMA,16357,10247,6110,49222.08351164639,46161.97911583878,54354.14402618658,6409,3963,2446,79548.04181619597,72032.32399697199,91724.9795584628,7305,4319,2986,30528.51745379877,31542.509840240797,29061.86202277294,2643,1965,678,27352.024214907302,26119.898218829516,30923.008849557522
14,Westchester County (Northeast) PUMA,7610,4054,3556,68725.308804205,83768.03157375431,51575.928008998875,4013,1759,2254,95661.02666334414,142301.30756111426,59263.3984028394,2332,1030,1302,42075.857632933104,46889.90291262136,38267.511520737324,1265,1265,0,32403.95256916996,32403.95256916996,0.0
15,Nassau County (East Central)--Oyster Bay Town (Central) PUMA,8029,5571,2458,76695.94881056172,82709.25740441572,63066.92432872254,4910,3271,1639,87561.50712830957,92003.88260470804,78695.72910311165,1736,1202,534,82591.34389400922,105358.21381031614,31344.569288389514,1383,1098,285,30720.318148951555,30225.865209471765,32625.263157894737
16,Niagara County (Southwest)--Greater Niagara Falls & North Tonawanda Area PUMA,530,228,302,17983.962264150945,11585.526315789473,22814.56953642384,18,0,18,17000.0,0.0,17000.0,316,184,132,14485.759493670887,4790.760869565217,28000.0,196,44,152,23714.285714285714,40000.0,19000.0
17,Nassau County (Central)--Hempstead Town (East Central) PUMA,2500,1352,1148,73327.364,91344.30473372781,52108.806620209056,954,613,341,122458.80503144654,125436.37846655792,117106.15835777126,964,677,287,56468.257261410785,66276.21861152141,33332.40418118467,582,62,520,20717.027491408935,28000.0,19848.673076923078
18,Niagara County (North & East) PUMA,244,125,119,28491.803278688523,48000.0,8000.0,0,0,0,#DIV/0!,0.0,0.0,0,0,0,#DIV/0!,0.0,0.0,244,125,119,28491.803278688523,48000.0,8000.0
19,"NYC-Queens Community District 13--Queens Village, Cambria Heights & Rosedale PUMA",19607,12081,7526,46993.50334064365,47326.49615098088,46458.9715652405,7125,4033,3092,58965.6449122807,55756.236052566324,63151.78525226391,10880,6902,3978,41060.04595588235,44717.820921472034,34713.65007541478,1602,1146,456,34043.757802746564,33371.815008726,35732.45614035088
20,"Chenango, Delaware & Broome (East) Counties PUMA",714,409,305,61767.50700280112,45687.041564792176,83331.14754098361,631,409,222,68313.78763866879,45687.041564792176,110000.0,83,0,83,12000.0,0.0,12000.0,0,0,0,#DIV/0!,0.0,0.0
21,Oswego County PUMA,769,423,346,44545.73472041613,33840.59101654846,57633.23699421965,379,33,346,57403.95778364116,55000.0,57633.23699421965,390,390,0,32050.17948717949,32050.17948717949,0.0,0,0,0,#DIV/0!,0.0,0.0
22,"NYC-Brooklyn Community District 9--Crown Heights South, Prospect Lefferts & Wingate PUMA",6171,3085,3086,49008.54091719332,42045.056726094,55969.768632534026,1952,485,1467,77002.04918032787,40276.28865979381,89143.83094751193,3074,1632,1442,38467.24463240078,49886.64215686275,25543.210818307907,1145,968,177,29585.498689956334,29710.743801652894,28900.542372881355
23,NYC-Queens Community District 10--Howard Beach & Ozone Park PUMA,9157,5722,3435,55435.505078082344,60802.603984620764,46495.02765647744,3895,2388,1507,73789.83825417202,81023.95309882746,62326.622428666225,4416,2576,1840,41330.41213768116,46504.23136645963,34087.065217391304,846,758,88,44558.39243498818,45689.182058047496,34818.181818181816
24,Ontario & Yates Counties PUMA,1060,376,684,118050.28301886792,289096.5425531915,24024.85380116959,298,177,121,380410.73825503356,599200.0,60363.63636363636,674,199,475,13547.3293768546,13275.879396984925,13661.052631578947,88,0,88,30000.0,0.0,30000.0
25,"NYC-Bronx Community District 8--Riverdale, Fieldston & Kingsbridge PUMA",9944,4748,5196,53914.01045856798,54295.012636899744,53565.85835257891,5078,2184,2894,66599.4289090193,67951.64835164836,65578.95646164478,3896,2116,1780,42280.54928131417,44979.82986767486,39071.74157303371,970,448,522,34230.927835051545,31716.51785714286,36388.88888888889
26,Erie County (Northwest) PUMA,1775,1224,551,32069.90422535211,30129.96732026144,36379.31034482759,407,313,94,55994.299754299755,42778.5303514377,100000.0,1298,911,387,24571.956856702618,25784.193194291987,21718.346253229975,70,0,70,32000.0,0.0,32000.0
27,NYC-Brooklyn Community District 14--Flatbush & Midwood PUMA,16806,9081,7725,49450.926395335,43732.77172117608,56172.8115210356,6609,2567,4042,66170.85928279618,53339.851967276976,74319.59648688768,7358,4582,2776,40588.26583310682,41054.670449585334,39818.42939481268,2839,1932,907,33497.92180345192,37319.565217391304,25357.4421168688
28,"Rockland County (West)--Spring Valley, Suffern Villages & Monsey PUMA",7677,4699,2978,53446.50254005471,58316.36518408172,45762.32370718603,2291,1651,640,86336.31601920558,93835.31193216232,66991.25,4335,2425,1910,41034.025374855824,40264.61855670103,42010.89005235602,1051,623,428,32949.38154138915,34453.93258426966,30759.345794392524
29,"NYC-Manhattan Community District 1 & 2--Battery Park City, Greenwich Village & Soho PUMA",14408,8147,6261,137614.58217656857,155083.9450104333,114882.92605015173,12802,7057,5745,148937.30667083268,172772.977185773,119658.22454308094,574,181,393,91901.56794425087,142005.52486187845,68825.69974554707,1032,909,123,22581.39534883721,20359.73597359736,39000.0
30,"NYC-Bronx Community District 4--Concourse, Highbridge & Mount Eden PUMA",12962,7320,5642,36549.78521833051,39602.52732240437,32589.12017015243,4532,2443,2089,45107.06443071492,45473.14776913631,44678.94494973672,6872,4005,2867,32971.4493597206,37862.621722846445,26138.821067317753,1558,872,686,27441.142490372273,31146.559633027522,22731.049562682216
31,NYC-Queens Community District 1--Astoria & Long Island City PUMA,26834,16966,9868,52666.76567041813,51117.98007780266,55329.584515606,13307,6931,6376,64173.24340572631,62549.03332852402,65938.83312421582,10850,7971,2879,41804.69493087558,43471.132856605196,37190.878777353246,2677,2064,613,39494.09787075084,42263.517441860466,30169.331158238172
32,Erie County (West Central)--Buffalo City (West) PUMA,2192,1594,598,39649.45255474452,42378.67001254705,32374.581939799333,1051,666,385,41060.989533777356,45285.43543543544,33753.246753246756,1089,928,161,38031.68044077135,40292.56465517241,25000.0,52,0,52,45000.0,0.0,45000.0
33,Schenectady County--Schenectady City PUMA,2828,2092,736,57592.07920792079,57976.48183556405,56499.45652173913,1334,896,438,74109.14542728636,72296.875,77816.43835616438,906,608,298,56230.68432671082,71455.59210526316,25167.78523489933,588,588,0,22217.34693877551,22217.34693877551,0.0
34,NYC-Brooklyn Community District 2--Brooklyn Heights & Fort Greene PUMA,5962,3483,2479,103869.65447836297,109484.64542061441,95980.58087938685,3784,1753,2031,143802.14587737844,182645.784369652,110275.36189069424,1967,1730,237,34376.492119979666,35350.84393063584,27264.135021097045,211,0,211,35568.72037914692,0.0,35568.72037914692
35,"Steuben (North & West), Schuyler & Chemung (North) Counties PUMA",68,37,31,38676.470588235294,25000.0,55000.0,0,0,0,#DIV/0!,0.0,0.0,68,37,31,38676.470588235294,25000.0,55000.0,0,0,0,#DIV/0!,0.0,0.0
36,NYC-Brooklyn Community District 1--Greenpoint & Williamsburg PUMA,7864,4674,3190,68056.65946083418,70761.25588361146,64093.87460815047,3402,1422,1980,87000.3644914756,106193.09423347398,73216.49494949495,3378,2345,1033,61699.171107164,65547.12153518124,52963.98838334947,1084,907,177,28415.61808118081,28691.874310915104,27000.0
37,Suffolk County (Northwest)--Huntington Town (North) PUMA,4357,3191,1166,46246.19233417489,39457.4302726418,64825.04288164665,1449,1176,273,68799.51690821256,47082.05782312925,162351.64835164836,1348,547,801,45583.086053412466,59078.610603290675,36367.04119850187,1560,1468,92,25870.615384615383,26038.256130790192,23195.652173913044
38,Erie County (Northeast) PUMA,512,423,89,113359.1796875,116169.97635933806,100000.0,361,272,89,145340.72022160664,160176.4705882353,100000.0,151,151,0,36900.0,36900.0,0.0,0,0,0,#DIV/0!,0.0,0.0
39,Monroe County (North & West) PUMA,750,231,519,77647.09333333334,71919.1341991342,80196.53179190752,324,0,324,98648.14814814815,0.0,98648.14814814815,426,231,195,61674.46009389671,71919.1341991342,49538.46153846154,0,0,0,#DIV/0!,0.0,0.0
40,Oneida County (Central)--Greater Utica & Rome Cities PUMA,3533,2006,1527,35085.37220492499,37897.96610169492,31390.50425671251,1039,588,451,49589.817131857555,61129.795918367345,34544.34589800444,1758,979,779,29366.83731513083,27204.290091930543,32084.59563543004,736,439,297,28268.885869565216,30628.70159453303,24780.80808080808
41,"NYC-Brooklyn Community District 12--Borough Park, Kensington & Ocean Parkway PUMA",7876,5441,2435,51451.95022854241,57280.72045579857,38427.58110882957,3903,2620,1283,66456.62311042787,75284.69465648854,48428.91660171473,2737,1629,1108,32020.189989039092,35600.49109883364,26756.371841155236,1236,1192,44,47100.40453074434,47336.661073825504,40700.0
42,Erie County (West Central)--Buffalo City (East) PUMA,671,468,203,24742.32488822653,23597.008547008547,27382.758620689656,126,53,73,53042.06349206349,75000.0,37100.0,417,369,48,15108.872901678656,13171.815718157182,30000.0,128,46,82,28268.75,48000.0,17200.0
43,Suffolk County (Northwest)--Smithtown Town PUMA,1804,707,1097,95649.17960088691,123166.90240452616,77914.42114858706,714,461,253,117438.54341736695,139550.97613882864,77146.71936758893,1090,246,844,81376.14678899082,92463.41463414633,78144.54976303318,0,0,0,#DIV/0!,0.0,0.0
44,Nassau County (Northeast)--Oyster Bay Town (North) & Glen Cove City PUMA,7872,4472,3400,104048.22281504064,133450.64400715564,65375.39117647059,4334,2153,2181,139048.50253807107,196030.4133766837,82798.13388353966,1772,936,836,56295.59819413092,68510.47008547008,42619.617224880385,1766,1383,383,66067.72366930917,79979.75415762834,15831.853785900783
45,NYC-Manhattan Community District 8--Upper East Side PUMA,16438,8675,7763,137964.4705560287,176297.77371757926,95127.75731031818,15708,8238,7470,142095.05774127832,182990.0931051226,96995.55287817938,730,437,293,49083.28767123288,50139.13043478261,47508.53242320819,0,0,0,#DIV/0!,0.0,0.0
46,Suffolk County (Southwest)--Islip Town (South) PUMA,3701,2375,1326,54904.6473925966,63077.38947368421,40266.440422322776,1152,890,262,82662.32638888889,90452.80898876404,56198.47328244275,1504,840,664,40462.16755319149,44827.380952380954,34939.909638554214,1045,645,400,45090.90909090909,49071.007751937985,38673.0
47,"NYC-Brooklyn Community District 6--Park Slope, Carroll Gardens & Red Hook PUMA",6174,3432,2742,102036.24392614189,115008.87237762238,85799.16849015317,5078,2605,2473,115003.2237101221,138721.47792706333,90018.97290739992,939,670,269,45795.95314164004,45310.44776119403,47005.204460966546,157,157,0,19000.0,19000.0,0.0
48,Erie County (South) PUMA,910,671,239,40468.51648351648,43652.04172876304,31530.669456066946,461,222,239,42633.47071583514,54586.48648648649,31530.669456066946,449,449,0,38245.701559020046,38245.701559020046,0.0,0,0,0,#DIV/0!,0.0,0.0
49,Albany County (Outside Albany City) PUMA,4712,3671,1041,81721.30730050933,89463.4432034868,54419.3083573487,3784,3008,776,91513.18710359409,98624.8670212766,63946.262886597935,802,537,265,42861.47132169576,50924.95344506518,26521.509433962263,126,126,0,35000.0,35000.0,0.0
50,NYC-Staten Island Community District 2--New Springville & South Beach PUMA,12875,7788,5087,53119.23883495146,58177.054442732406,45375.91900923924,5557,3143,2414,64514.990102573334,71753.57938275533,55090.43082021541,6220,4102,2118,47008.102893890675,50556.65529010239,40135.50519357885,1098,543,555,30063.75227686703,37160.22099447514,23120.72072072072
51,Erie County (North Central) PUMA,3021,1453,1568,97329.91194968553,107888.43771507226,87545.76785714286,2580,1315,1265,110465.37364341086,115140.60836501901,105605.34703557313,244,138,106,29754.09836065574,38782.608695652176,18000.0,197,0,197,9000.0,0.0,9000.0
52,"NYC-Staten Island Community District 3--Tottenville, Great Kills & Annadale PUMA",11966,7461,4505,71642.34999164299,74336.05950944913,67181.13651498336,6091,3449,2642,81194.12247578394,86880.96259785445,73770.23467070401,5530,3734,1796,62698.05786618445,64018.184252811996,59953.429844098,345,278,67,46373.04347826087,57284.17266187051,1100.0
53,"NYC-Manhattan Community District 12--Washington Heights, Inwood & Marble Hill PUMA",20639,10235,10404,33661.459712195356,35751.63654127992,31605.23519800077,5344,2177,3167,41118.17739520958,37119.77032613689,43866.687717082415,11875,5921,5954,32312.755115789474,39944.215504137814,24723.592038965402,3420,2137,1283,26692.795321637426,22741.488067384184,33274.20109119252
54,NYC-Manhattan Community District 7--Upper West Side & West Side PUMA,12122,5687,6435,142956.87840290382,194208.94672059081,97662.31546231546,9039,4459,4580,169623.75926540548,227956.07983852882,112832.5327510917,2968,1113,1855,65073.82749326146,73185.19317160826,60207.00808625337,115,115,0,57000.0,57000.0,0.0
55,"NYC-Queens Community District 5--Ridgewood, Glendale & Middle Village PUMA",21687,12419,9268,56565.95333609997,61026.403092036395,50589.00841605524,7514,2866,4648,67518.57599148256,72721.42358688067,64310.451807228914,12226,8176,4050,52070.157860297724,59696.58757338552,36674.18518518518,1947,1377,570,42527.73497688752,44580.97312999274,37567.54385964912
56,"NYC-Brooklyn Community District 15--Sheepshead Bay, Gerritsen Beach & Homecrest PUMA",20068,10351,9717,65633.67649990034,74074.20152642256,56642.43696614182,12264,5751,6513,80051.19699934768,97428.74630499043,64706.76493167511,6837,3840,2997,43230.69182389937,45336.260416666664,40532.866199532866,967,760,207,41179.4208893485,42550.13157894737,36146.85990338164
57,"NYC-Queens Community District 12--Jamaica, Hollis & St. Albans PUMA",13650,8185,5465,37945.1978021978,37118.84422724496,39182.83806038427,5031,2979,2052,48158.757702246075,42715.172876804296,56061.505847953216,6029,3750,2279,35031.54752031846,35862.0,33665.072400175515,2590,1456,1134,24888.04633204633,28905.728021978022,19729.541446208113
58,Suffolk County (North Central)--Brookhaven Town (North) PUMA,2627,1774,853,136512.66844309098,147627.6099210823,113396.71746776084,2237,1499,738,141059.80330800178,148281.10740493663,126392.14092140921,390,275,115,110430.76923076923,144065.45454545456,30000.0,0,0,0,#DIV/0!,0.0,0.0
59,Albany County (East Central)--Albany City PUMA,749,297,452,73041.92256341789,33242.42424242424,99193.36283185841,315,178,137,54171.42857142857,44943.8202247191,66160.58394160584,365,50,315,99921.64383561644,14000.0,113560.0,69,69,0,17000.0,17000.0,0.0
60,NYC-Manhattan Community District 3--Chinatown & Lower East Side PUMA,7467,3820,3647,110055.49658497388,101969.73638743456,118524.81491636962,4988,2455,2533,144048.61046511628,135086.83054989818,152734.42558231347,1960,986,974,43544.063265306126,46351.58620689655,40701.95071868583,519,379,140,34534.79768786127,32146.5963060686,41000.0
61,Rensselaer County--Troy City PUMA,1819,1423,396,50030.775151181966,53000.126493323965,39360.606060606064,759,450,309,50764.03162055336,54851.333333333336,44811.65048543689,697,610,87,72546.62840746055,80040.98360655738,20000.0,363,363,0,5264.683195592286,5264.683195592286,0.0
62,Warren & Washington Counties PUMA,638,347,291,33762.69592476489,47586.16714697406,17279.037800687285,381,208,173,34169.02887139108,50112.5,15000.0,193,75,118,37524.35233160622,64120.0,20620.338983050846,64,64,0,20000.0,20000.0,0.0
63,Orange County (Northeast)--Greater Newburgh City PUMA,2963,1550,1413,51617.833277084035,60427.50967741935,41953.99858457183,1033,473,560,65626.33107454017,90871.03594080338,44303.57142857143,1046,408,638,33054.14913957935,38724.60784313725,29427.899686520377,884,669,215,57213.800904977375,52139.0134529148,73004.6511627907
64,"Rockland County (South)--Orangetown, Clarkstown (South) & Ramapo (Southeast) Towns PUMA",5347,2779,2568,94906.68599214513,80978.24757106873,109979.55607476635,2623,1476,1147,87982.90125810141,95670.4268292683,78090.32258064517,2049,941,1108,122437.28648121035,66742.82678002125,169737.36462093864,675,362,313,38241.333333333336,58077.34806629834,15300.0
65,Fulton & Montgomery Counties PUMA,429,183,246,36944.055944055945,65311.475409836065,15841.463414634147,255,136,119,41831.37254901961,74058.82352941176,5000.0,174,47,127,29781.6091954023,40000.0,26000.0,0,0,0,#DIV/0!,0.0,0.0
66,NYC-Brooklyn Community District 11--Bensonhurst & Bath Beach PUMA,26644,14198,12446,51367.058774958714,50748.97872939851,52072.14478547325,14953,7324,7629,61190.51588310038,62077.17367558711,60339.30580678988,9290,4925,4365,41127.22604951561,41700.15837563452,40480.790378006874,2401,1949,452,29808.49645980841,31045.407901487943,24475.0
67,Monroe County (Central)--Rochester City (East) PUMA,1513,678,835,31137.11169861203,28219.174041297934,33506.40718562874,318,51,267,42805.81761006289,100000.0,31881.086142322096,751,337,414,23484.953395472705,26562.61127596439,20979.710144927536,444,290,154,35722.97297297297,17520.689655172413,70000.0
68,Chautauqua County PUMA,364,296,68,26103.846153846152,27506.08108108108,20000.0,100,32,68,17440.0,12000.0,20000.0,203,203,0,28600.0,28600.0,0.0,61,61,0,32000.0,32000.0,0.0
69,Nassau County (Northwest)--North Hempstead Town (North) PUMA,8732,5433,3299,95040.33669262483,107081.8590097552,75209.60290997272,5134,2528,2606,105366.47448383327,128663.28322784811,82766.96085955488,3472,2867,605,82407.47119815668,88758.61876525986,52310.38016528926,126,38,88,22396.825396825396,53789.47368421053,8840.90909090909
70,"Clinton, Franklin, Essex & Hamilton Counties PUMA",752,424,328,40282.18085106383,42663.443396226416,37203.96341463415,440,252,188,45035.0,49478.1746031746,39079.255319148935,220,127,93,30076.363636363636,28667.716535433072,32000.0,92,45,47,41956.52173913043,44000.0,40000.0
71,NYC-Queens Community District 6--Forest Hills & Rego Park PUMA,18293,9846,8447,80572.65806592685,93988.24700385943,64935.16680478276,11488,5585,5903,103173.51096796658,134701.47896150404,73343.98339827206,5950,3648,2302,43801.03193277311,42000.49890350877,46654.352736750654,855,613,242,32797.89473684211,32435.073409461664,33716.94214876033
72,Monroe County (Central)--Rochester City (West) PUMA,2119,1404,715,26478.00849457291,28331.33903133903,22838.74125874126,345,226,119,64864.057971014496,72743.36283185841,49900.0,1713,1117,596,18336.71920607122,18817.547000895254,17435.57046979866,61,61,0,38000.0,38000.0,0.0
73,Orange County (Southeast) PUMA,3887,2225,1662,96260.84898379212,78766.3011235955,119681.64861612515,1784,1185,599,148122.365470852,103567.93248945147,236264.27378964942,1777,714,1063,54143.84918401801,54376.77871148459,53987.39416745061,326,326,0,42030.67484662577,42030.67484662577,0.0
74,Rockland County (North)--New City & Congers PUMA,7039,3621,3418,57884.482170762894,57775.21955260978,58000.234055002926,2379,1355,1024,89711.47540983607,85841.18081180812,94832.8125,3700,1763,1937,47194.01891891892,46011.497447532616,48270.31491997935,960,503,457,20216.041666666668,23401.59045725646,16709.84682713348
75,Westchester County (Southeast) PUMA,13497,9100,4397,81116.40586797066,89652.6021978022,63449.95451444166,6554,4408,2146,119412.00030515715,130823.48003629764,95972.20410065238,4915,2987,1928,50521.33875890132,61334.77736859726,33768.36099585062,2028,1705,323,31503.698224852073,32822.17008797654,24543.962848297215
76,"NYC-Manhattan Community District 9--Hamilton Heights, Manhattanville & West Harlem PUMA",11850,5852,5998,47397.89198312236,39525.05468215994,55079.093031010336,4767,2429,2338,77262.40822320117,51681.30918073281,103839.17878528657,4718,2364,2354,30499.41076727427,35569.25549915397,25408.028887000848,2365,1059,1306,20912.854122621564,20473.087818696884,21269.448698315467
77,Nassau County (Southwest)--Hempstead Town (Southwest) & Long Beach City PUMA,5236,2700,2536,79347.4025974026,92363.62962962964,65489.43217665615,2932,951,1981,102368.41746248295,162033.64879074658,73725.49217566886,1595,1040,555,60194.23197492163,73056.53846153847,36091.89189189189,709,709,0,27234.13258110014,27234.13258110014,0.0
78,NYC-Queens Community District 2--Sunnyside & Woodside PUMA,25756,16914,8842,51444.07827302376,50847.145559891214,52585.96019000226,12287,7565,4722,71481.88166354684,73612.08460013219,68069.13595933927,10105,6879,3226,30374.626422563088,26901.177496729175,37781.277123372594,3364,2470,894,41545.838287752675,47813.76518218624,24228.41163310962
79,"NYC-Bronx Community District 11--Pelham Parkway, Morris Park & Laconia PUMA",12245,7194,5051,48851.90200081666,47337.99555184876,51008.11720451396,4016,2332,1684,70010.61752988047,63981.23499142367,78360.09501187649,7361,3994,3367,39290.870805597064,40945.543314972456,37328.06652806653,868,868,0,32037.78801843318,32037.78801843318,0.0
80,Onondaga County (Central)--Syracuse City (Outer) PUMA,1863,1075,788,47853.913043478264,48479.8511627907,47000.0,1129,522,607,47695.16386182462,43195.095785440615,51565.07413509061,591,482,109,51153.976311336715,55452.282157676345,32146.788990825688,143,71,72,35468.531468531466,40000.0,31000.0
81,Wayne & Seneca Counties PUMA,761,612,149,48402.10249671485,27539.21568627451,134093.9597315436,692,612,80,47245.66473988439,27539.21568627451,198000.0,69,0,69,60000.0,0.0,60000.0,0,0,0,#DIV/0!,0.0,0.0
82,"NYC-Bronx Community District 7--Bedford Park, Fordham North & Norwood PUMA",12683,8341,4342,37143.031459433885,39110.01894257283,33364.44035006909,3719,2635,1084,44232.965851035224,42049.715370018974,49540.03690036901,6689,4154,2535,36304.111227388246,39132.69138180067,31669.033530571993,2275,1552,723,28019.546373626374,34058.2912371134,15056.7081604426
83,Nassau County (West Central)--Hempstead Town (Northwest) PUMA,9693,6428,3265,83385.59785412153,98572.05973864344,53487.1056661562,4441,2845,1596,130251.27223598289,166326.53778558876,65944.17293233082,4322,2816,1506,44899.930587690884,45953.125,42930.61088977424,930,767,163,38444.30107526882,40440.93872229465,29049.079754601225
84,NYC-Brooklyn Community District 18--Canarsie & Flatlands PUMA,15882,8127,7755,53385.20715275154,56653.8009105451,49959.82205029014,6712,2632,4080,71545.13706793802,84127.02887537994,63428.583333333336,7175,4448,2727,44587.60975609756,47688.91636690647,39529.07957462413,1995,1047,948,23928.220551378447,25676.026743075454,21997.89029535865
85,"NYC-Bronx Community District 12--Wakefield, Williamsbridge & Woodlawn PUMA",4913,3192,1721,51784.235701200894,61544.00062656642,33682.452062754215,1905,1056,849,59255.69553805774,78117.61363636363,35794.93521790342,2736,1864,872,45824.945175438595,52467.5160944206,31625.688073394496,272,272,0,59400.0,59400.0,0.0
86,Suffolk County (South Central)--Brookhaven Town (South) PUMA,3691,3105,586,42291.30316987266,43063.832528180355,38197.95221843004,746,415,331,36164.879356568366,40677.10843373494,30507.552870090636,2376,2121,255,46286.78451178451,46059.12305516266,48180.39215686275,569,569,0,33639.367311072056,33639.367311072056,0.0
87,NYC-Queens Community District 4--Elmhurst & South Corona PUMA,32213,22311,9902,41027.663055288234,39998.38420510062,43346.81478489194,12283,8648,3635,55208.573638361966,54933.85175763182,55862.16231086657,16101,10790,5311,32182.313520899323,29891.75440222428,36835.88778007908,3829,2873,956,32731.723687646907,32998.2492168465,31930.753138075313
88,Livingston & Wyoming Counties PUMA,298,63,235,39743.32214765101,53968.25396825397,35929.82978723404,20,20,0,84000.0,84000.0,0.0,278,43,235,36559.388489208635,40000.0,35929.82978723404,0,0,0,#DIV/0!,0.0,0.0
89,"NYC-Bronx Community District 10--Co-op City, Pelham Bay & Schuylerville PUMA",7219,3740,3479,52387.93323174955,63082.96524064171,40890.543259557344,2965,1382,1583,56972.947723440135,71853.68306801736,43981.68035375869,3345,1788,1557,57110.34379671151,68759.22818791946,43733.20488118176,909,570,339,20054.565456545653,24012.280701754386,13400.0
90,Cattaraugus & Allegany Counties PUMA,358,162,196,292194.66480446927,587010.0,48520.76530612245,350,162,188,298727.1142857143,587010.0,50313.13829787234,8,0,8,6400.0,0.0,6400.0,0,0,0,#DIV/0!,0.0,0.0
91,Herkimer (North & Central) & Oneida (Outer) Counties PUMA,347,224,123,52939.337175792505,69167.41071428571,23385.772357723577,170,170,0,85270.0,85270.0,0.0,177,54,123,21887.28813559322,18474.074074074073,23385.772357723577,0,0,0,#DIV/0!,0.0,0.0
92,Orange County (Northwest) PUMA,3665,1646,2019,49299.69986357435,56367.67922235723,43537.493808816245,1595,519,1076,58053.416927899685,68847.78420038536,52846.84014869889,1849,906,943,40810.05949161709,49027.37306843267,32915.164369034996,221,221,0,57151.13122171946,57151.13122171946,0.0
93,Columbia & Greene Counties PUMA,511,424,87,150097.84735812133,176382.0754716981,22000.0,310,310,0,235458.06451612903,235458.06451612903,0.0,201,114,87,18447.761194029852,15736.842105263158,22000.0,0,0,0,#DIV/0!,0.0,0.0
94,Suffolk County (East) PUMA,5320,3672,1648,69518.62406015038,81716.38888888889,42340.10922330097,1406,794,612,142340.4694167852,199514.48362720403,68163.72549019608,2628,1964,664,53252.511415525114,59487.780040733196,34809.638554216865,1286,914,372,23142.13063763608,27148.884026258205,13297.58064516129
95,Monroe County (East) PUMA,2786,1439,1347,59767.48025843503,62198.74913134121,57170.15590200445,1040,487,553,95786.53846153847,116117.0431211499,77882.45931283906,1531,737,794,37854.474199869364,32586.160108548167,42744.58438287154,215,215,0,41576.74418604651,41576.74418604651,0.0
96,Sullivan & Ulster (West) Counties PUMA,2535,997,1538,54650.82445759369,59019.89969909729,51818.5955786736,973,267,706,79269.47584789312,137880.8988764045,57103.39943342776,1531,699,832,39269.131286740696,29669.58512160229,47334.13461538462,31,31,0,41600.0,41600.0,0.0
97,Cayuga & Onondaga (South) Counties PUMA,144,144,0,86437.5,86437.5,0.0,103,103,0,96961.16504854368,96961.16504854368,0.0,41,41,0,60000.0,60000.0,0.0,0,0,0,#DIV/0!,0.0,0.0
98,"NYC-Bronx Community District 1 & 2--Hunts Point, Longwood & Melrose PUMA",10815,6051,4764,33242.77669902913,35562.62601222938,30296.2174643157,2329,986,1343,42634.56419063976,38909.63488843814,45369.32241250931,6364,3897,2467,31618.562225015714,37811.68847831665,21835.5816781516,2122,1168,954,27805.93779453346,25233.219178082192,30955.765199161426
99,Suffolk County (Southwest)--Babylon Town (Southeast) PUMA,3961,2318,1643,44592.375662711434,45848.058671268336,42820.8155812538,1457,867,590,57525.4632807138,64490.19607843137,47290.84745762712,1547,739,808,35056.10859728507,23538.2949932341,45590.346534653465,957,712,245,40317.65935214211,46303.370786516854,22922.448979591838
100,Onondaga County (Central)--Syracuse City PUMA,3540,2296,1244,39958.180790960454,43101.76829268293,34156.18971061093,1636,1117,519,62014.76772616137,64362.09489704566,56962.813102119464,1334,841,493,20600.07496251874,21529.36979785969,19014.80730223124,570,338,232,21956.666666666668,26517.751479289942,15311.637931034482
101,Ulster County (East) PUMA,2745,1907,838,42795.62841530055,45160.98584163608,37412.88782816229,621,491,130,88895.97423510467,88338.900203666,91000.0,1214,943,271,34797.364085667214,36303.28738069989,29557.19557195572,910,473,437,22006.153846153848,17999.154334038056,26343.24942791762
102,NYC-Queens Community District 9--Richmond Hill & Woodhaven PUMA,21874,13735,8139,42815.56368291122,47122.409901710955,35547.529180489,6077,3697,2380,56732.12769458615,60480.36245604544,50909.76470588235,12955,7934,5021,38596.39752991123,44085.48399294177,29922.744473212508,2842,2104,738,32290.70021111893,35102.742395437264,24273.71273712737
103,NYC-Brooklyn Community District 13--Brighton Beach & Coney Island PUMA,12542,7348,5194,62587.39355764631,62874.7754491018,62180.83172891798,6547,3196,3351,78583.36489995418,81109.19899874844,76174.3628767532,4557,2844,1713,47516.469168312484,54412.0253164557,36068.15528312901,1438,1308,130,37519.64534075104,36720.98623853211,45555.38461538462
104,Broome County (West Central)--Greater Binghamton City & Greater Johnson City Village PUMA,2245,1603,642,65940.85523385301,79958.40299438553,30940.654205607476,1426,923,503,83004.29172510518,109468.06067172265,34443.53876739563,718,579,139,20367.82729805014,20872.711571675303,18264.748201438848,101,101,0,149000.0,149000.0,0.0
105,Nassau County (South Central)--Hempstead Town (Southeast) PUMA,5391,2646,2745,59709.404563160824,66286.43235071807,53369.581056466304,2244,897,1347,82602.58467023174,111583.27759197324,63303.63771343727,2950,1552,1398,43517.016949152545,43263.98195876289,43797.92560801144,197,197,0,41411.16751269036,41411.16751269036,0.0
106,Saratoga County (Outer) PUMA,524,166,358,43762.59541984733,44939.75903614458,43216.75977653631,253,0,253,48547.03557312253,0.0,48547.03557312253,271,166,105,39295.94095940959,44939.75903614458,30373.333333333332,0,0,0,#DIV/0!,0.0,0.0
107,"NYC-Manhattan Community District 4 & 5--Chelsea, Clinton & Midtown Business District PUMA",13605,7651,5954,91793.85740536568,95847.58855051627,86584.73799126637,9419,5772,3647,112567.81293130906,111469.57726957728,114305.95832190842,2940,1589,1351,51424.897959183676,52943.67526746381,49638.56402664693,1246,290,956,30008.025682182986,20000.0,33043.9330543933
108,NYC-Brooklyn Community District 4--Bushwick PUMA,6171,4508,1663,35313.71414681575,35852.513309671696,33853.15694527962,868,447,421,42089.688940092165,51753.57941834452,31828.97862232779,3643,2718,925,38491.21054076311,39829.02133922002,34560.21621621621,1660,1343,317,24797.349397590362,22512.28592702904,34478.233438485804
109,Suffolk County (Central)--Islip Town (East) PUMA,932,637,295,60706.75965665236,55536.106750392464,71871.86440677966,386,237,149,90718.91191709845,80592.8270042194,106825.5033557047,467,321,146,41940.47109207709,44551.40186915888,36200.0,79,79,0,25000.0,25000.0,0.0
110,Westchester County (Southwest)--Yonkers City PUMA,15324,8864,6460,64191.89702427565,70835.84499097473,55075.49535603715,7025,3479,3546,79352.97224199289,89242.0896809428,69650.70501974055,6535,4064,2471,50390.66564651875,58519.21751968504,37021.81303116147,1764,1321,443,54942.74376417234,60252.53595760787,39109.25507900677
111,Nassau County (West Central)--North Hempstead Town (South) PUMA,13323,6738,6585,74241.23523230504,76667.01276343128,71759.09567198178,8288,4240,4048,87677.88513513513,82781.58773584905,92806.41798418973,3823,1582,2241,52640.11640073241,69933.24905183312,40432.291387773315,1212,916,296,50493.81188118812,59993.44978165939,21096.283783783783
112,"NYC-Queens Community District 8--Briarwood, Fresh Meadows & Hillcrest PUMA",21260,10855,10405,54883.00649106303,63015.34315983418,46398.95896203748,9964,5439,4525,70030.70052187877,79568.82699025556,58565.97790055248,10352,4747,5605,39832.47855486863,43068.82241415631,37091.546476360396,944,669,275,60043.43220338983,69968.60986547085,35898.181818181816
113,Jefferson & Lewis Counties PUMA,423,260,163,81909.21985815602,119492.30769230769,21960.73619631902,260,260,0,119492.30769230769,119492.30769230769,0.0,163,0,163,21960.73619631902,0.0,21960.73619631902,0,0,0,#DIV/0!,0.0,0.0
114,Suffolk County (Central)--Brookhaven Town (West Central) PUMA,3141,1608,1533,80708.88252148997,105639.41542288558,54558.65622961513,1634,889,745,115552.87637698898,151661.3948256468,72464.9932885906,896,493,403,49529.46428571428,56525.35496957404,40971.2158808933,611,226,385,33248.445171849424,31744.24778761062,34131.42857142857
115,Suffolk County (Northwest)--Huntington Town (South) PUMA,4334,2305,2029,80568.2510383018,89405.72668112798,70528.63479546574,1764,997,767,114008.27664399093,141792.37713139417,77892.56844850065,2100,975,1125,39561.23809523809,48936.205128205125,31436.266666666666,470,333,137,138284.25531914894,51052.252252252256,350315.3284671533
116,NYC-Brooklyn Community District 16--Brownsville & Ocean Hill PUMA,3292,2064,1228,36668.985419198056,39357.751937984496,32149.75570032573,771,452,319,52842.801556420236,52034.95575221239,53987.46081504702,1047,701,346,41995.319961795605,49634.522111269616,26518.20809248555,1474,911,563,24425.644504748983,25160.04390779363,23237.300177619894
117,"NYC-Staten Island Community District 1--Port Richmond, Stapleton & Mariner's Harbor PUMA",12246,7289,4957,51315.923566878984,50991.53519001235,51792.919104296954,4732,2605,2127,67288.5460693153,64121.65067178503,71167.13681241185,5982,3487,2495,45155.53326646607,49198.22196730714,39505.49098196393,1532,1197,335,26034.595300261095,27640.93567251462,20294.925373134327
118,Chemung (South) & Steuben (East) Counties--Greater Elmira & Greater Corning Cities PUMA,1161,755,406,176174.5908699397,249415.49668874172,39975.36945812808,1047,690,357,191099.52244508118,268794.49275362317,40932.773109243695,114,65,49,39100.87719298246,43700.0,33000.0,0,0,0,#DIV/0!,0.0,0.0
119,Monroe County (Central)--Greece & Gates Towns PUMA,2305,1025,1280,42027.73101952278,48334.55609756098,36977.34375,526,449,77,52241.44486692015,50910.9131403118,60000.0,1626,423,1203,37595.239852398525,43543.40425531915,35503.740648379055,153,153,0,54020.0,54020.0,0.0
120,NYC-Queens Community District 3--Jackson Heights & North Corona PUMA,29358,19709,9649,42972.15818516248,44673.78456542696,39496.42449994818,8014,5104,2910,62868.898178188174,61640.86010971787,65022.817869415805,13924,8919,5005,37762.02025280092,42141.24565534253,29958.16183816184,7420,5686,1734,31259.690026954177,33415.91628561379,24189.158016147634
121,"NYC-Queens Community District 14--Far Rockaway, Breezy Point & Broad Channel PUMA",3599,2050,1549,52537.399277577104,49824.39024390244,56127.888960619755,2020,965,1055,60620.544554455446,60818.65284974093,60439.336492890994,904,587,317,45807.5221238938,44868.824531516184,47545.74132492114,675,498,177,37360.88888888889,34361.44578313253,45800.0
122,NYC-Brooklyn Community District 10--Bay Ridge & Dyker Heights PUMA,14493,9019,5474,56089.68605533706,57741.10987914403,53368.78881987578,8203,4599,3604,72523.50237717909,79021.556860187,64231.45116537181,4841,3159,1682,32820.064036356125,33360.02849002849,31805.945303210465,1449,1261,188,40797.51552795031,41207.454401268835,38047.87234042553
123,Broome (Outer West) & Tioga Counties PUMA,360,257,103,90374.16666666667,123387.93774319066,8000.0,167,167,0,98352.69461077845,98352.69461077845,0.0,193,90,103,83470.46632124353,169842.22222222222,8000.0,0,0,0,#DIV/0!,0.0,0.0
124,Putnam County PUMA,4780,2641,2139,55134.28870292887,50671.14729269216,60644.88078541374,2075,824,1251,71088.19277108433,89373.30097087378,59044.28457234213,1791,1187,604,45931.267448352875,31794.35551811289,73713.5761589404,914,630,284,36948.577680525166,35617.46031746032,39901.40845070423
125,"NYC-Brooklyn Community District 17--East Flatbush, Farragut & Rugby PUMA",6978,2999,3979,37061.490398394955,33303.80126708903,39893.68685599397,1768,385,1383,53922.5,53779.22077922078,53962.38611713666,4267,2180,2087,31364.82306069838,30509.816513761467,32257.930043124103,943,434,509,31226.299045599153,29174.423963133642,32975.83497053045
126,"NYC-Queens Community District 11--Bayside, Douglaston & Little Neck PUMA",16674,8895,7779,60234.089120786855,63636.10567734682,56344.008484381025,9048,4535,4513,71214.75795755968,77178.93274531422,65221.508974074895,6352,3453,2899,49460.338790931986,52386.475528525916,45975.01621248706,1274,907,367,35965.46310832025,38749.94487320838,29083.92370572207
127,Nassau County (Central)--Hempstead Town (Northeast) PUMA,7734,4353,3381,65679.68709594001,59217.22949689869,74000.0295770482,2556,1275,1281,79997.69170579029,64766.35294117647,95157.68930523029,4478,2736,1742,56726.79767753461,59395.2850877193,52535.64867967853,700,342,358,70671.42857142857,37105.26315789474,102737.43016759776
128,Suffolk County (Central)--Brookhaven Town (Central) PUMA,6768,3949,2819,54596.92080378251,52696.05976196506,57259.74459028024,2669,1115,1554,77521.90333458224,81893.93721973094,74384.95495495496,3537,2272,1265,38995.193666949395,40539.17253521127,36222.134387351776,562,562,0,43914.59074733096,43914.59074733096,0.0
129,NYC-Manhattan Community District 10--Central Harlem PUMA,6491,3805,2686,56254.99922970266,49682.91721419185,65565.0409530901,4286,2453,1833,72353.80307979468,65751.8956379943,81188.76159301691,1462,706,756,30755.882352941175,25325.920679886687,35826.71957671957,743,646,97,13563.526244952895,15284.82972136223,2100.0
130,"NYC-Bronx Community District 5--Morris Heights, Fordham South & Mount Hope PUMA",10139,5761,4378,31487.266988854917,33668.93247700052,28616.418455915944,2486,1857,629,35916.33145615447,37638.12600969306,30833.068362480128,6379,3229,3150,31982.113183884623,33049.495199752244,30887.961904761905,1274,675,599,20366.954474097332,25712.444444444445,14343.238731218698
131,NYC-Manhattan Community District 11--East Harlem PUMA,9857,5431,4426,57141.377701126105,48826.28613515006,67344.55490284681,3094,1680,1414,98741.35746606335,97830.21428571429,99823.90381895332,4815,2688,2127,45212.6272066459,28968.675595238095,65740.94969440527,1948,1063,885,20553.388090349075,21592.662276575727,19305.084745762713
132,Westchester County (Northwest) PUMA,9104,4634,4470,63238.02614235501,67294.5921450151,59032.62863534676,4491,2165,2326,96281.85036740146,113468.79445727482,80284.54428202924,4026,1928,2098,32556.631892697467,29050.311203319503,35778.83698760725,587,541,46,20858.94378194208,18806.284658040666,45000.0
133,Onondaga County (North) PUMA,2119,981,1138,62008.21142048136,63771.661569826705,60488.04920913884,1468,575,893,70155.99455040872,70739.13043478261,69780.51511758119,587,342,245,39888.24531516184,49394.73684210526,26617.95918367347,64,64,0,78000.0,78000.0,0.0
134,NYC-Brooklyn Community District 8--Crown Heights North & Prospect Heights PUMA,4363,2110,2253,53482.36167774467,61692.864454976305,45792.98712827342,1612,682,930,89433.71215880894,118549.03812316715,68082.47311827957,2214,1133,1081,34478.00361336947,36967.519858782,31868.732654949123,537,295,242,23914.525139664805,25211.186440677968,22333.88429752066
135,NYC-Brooklyn Community District 3--Bedford-Stuyvesant PUMA,4188,3211,977,50152.67430754537,51711.554033011525,45029.273285568066,1614,1367,247,67725.40272614622,71070.81199707389,49210.52631578947,2240,1510,730,38672.142857142855,36282.78145695364,43614.520547945205,334,334,0,42230.53892215569,42230.53892215569,0.0
136,Genesee & Orleans Counties PUMA,308,129,179,25375.324675324675,30062.01550387597,21997.765363128492,41,14,27,32085.365853658535,12000.0,42500.0,206,54,152,24029.611650485436,40000.0,18355.92105263158,61,61,0,25409.83606557377,25409.83606557377,0.0
137,Westchester County (Central)--White Plains City PUMA,11633,6807,4826,96359.73523596664,99004.60555310709,92629.1856610029,6765,3204,3561,135713.68810051738,164096.08302122346,110176.70598146589,3446,2495,951,45098.46198491004,45304.24849699399,44558.56992639327,1422,1108,314,33361.74402250352,31702.527075812275,39216.56050955414
138,Saratoga County (South & Central) PUMA,2132,820,1312,72315.12664165103,89420.73170731707,61624.123475609755,1678,527,1151,82643.53396901072,112981.02466793169,68753.12771503041,454,293,161,34140.96916299559,47044.368600682596,10658.385093167703,0,0,0,#DIV/0!,0.0,0.0
139,Monroe County (South) PUMA,5051,2886,2165,83680.1128489408,107612.15176715176,51778.09699769053,3488,1923,1565,104142.78956422018,142424.16536661467,57104.39616613418,1287,963,324,31499.7668997669,38096.573208722744,11892.592592592593,276,0,276,68398.55072463768,0.0,68398.55072463768
140,Suffolk County (Central)--Islip Town (Northwest) PUMA,16326,9044,7282,41428.4282739189,45657.16718266254,36176.47624279044,2297,874,1423,51562.995211144975,61717.84897025172,45325.93113141251,11305,6130,5175,38963.354268023,41562.71125611746,35884.30917874396,2724,2040,684,43112.922173274594,51079.705882352944,19352.33918128655
141,St. Lawrence County PUMA,1334,208,1126,94252.84857571214,200111.53846153847,74698.134991119,953,160,793,118796.64218258132,255645.0,91185.37200504413,333,0,333,35435.73573573573,0.0,35435.73573573573,48,48,0,15000.0,15000.0,0.0
142,Nassau County (West Central)--Hempstead Town (West Central) PUMA,8492,4193,4299,57023.492699010836,54736.70403052707,59253.89625494301,3870,1733,2137,66531.91214470284,67706.28967109059,65579.55077211044,4508,2409,2099,48411.490683229815,45824.40846824409,51380.657455931396,114,51,63,74789.47368421052,35000.0,107000.0
143,Nassau County (Central)--Hempstead Town (North Central)--Meadowbrook Corridor PUMA,6851,4378,2473,41646.24872281419,42184.85609867519,40692.741609381315,1503,705,798,64970.85828343313,60525.39007092199,68898.24561403508,3184,1868,1316,33907.0351758794,38953.586723768734,26743.693009118542,2164,1805,359,36833.29482439926,38365.42936288089,29129.944289693594
144,"NYC-Bronx Community District 9--Castle Hill, Clason Point & Parkchester PUMA",10393,6668,3725,37912.72972192822,38769.54109178164,36378.97986577181,3269,1725,1544,48634.475374732334,48276.115942028984,49034.844559585494,6114,4332,1782,35109.99345763821,37290.37396121884,29809.539842873175,1010,611,399,20176.633663366338,22417.512274959085,16745.112781954886
145,Nassau County (Southeast)--Oyster Bay Town (South) PUMA,3132,1623,1509,46967.544699872284,54916.63585951941,38417.92577866137,585,315,270,71348.54700854702,84552.38095238095,55944.07407407407,2446,1308,1138,41011.222403924774,47779.5871559633,33231.76625659051,101,0,101,50000.0,0.0,50000.0
146,Capital Region,13913,9240,4673,69647.35355422986,76524.09956709956,56049.85020329553,8814,5577,3237,83697.53233492172,96302.86892594585,61979.90423231387,3889,2453,1436,53858.498328619185,60401.01916021199,42682.45125348189,1210,1210,0,18047.834710743802,18047.834710743802,0.0
147,Central NY,8900,5131,3769,53232.9404494382,58388.10563243033,46214.858052533826,5012,2523,2489,70500.51875498804,81642.01347602061,59206.83005222981,3111,2135,976,31451.38862102218,35977.316159250586,21550.92213114754,777,473,304,29059.58815958816,35507.399577167016,19027.302631578947
148,Finger Lakes,16951,8843,8108,60712.255914105364,74405.85887142373,45777.31129748397,7092,3959,3133,99739.32600112804,126190.97499368527,66313.83019470156,8561,4104,4457,30759.38441770821,32219.269005847953,29415.124523221897,1298,780,518,45031.63328197227,33529.5641025641,62351.35135135135
149,Long Island,150698,88273,62425,67304.7899773056,73855.88815379562,58041.112134561474,61646,32338,29308,95517.38899523084,112057.9006741295,77266.84079432237,68086,40199,27887,49255.70863319919,54863.68524092639,41171.832574317785,20966,15736,5230,42965.186492416295,43866.747585155055,40252.57361376673
150,Mid-Hudson,119572,68241,51331,70278.25753520892,74642.10753066339,64476.82199840253,51933,26841,25092,103705.21210020603,121203.64256175254,84987.07994579946,51558,29631,21927,47764.76783428372,47910.775876615706,47567.4602088749,16081,11769,4312,34508.62073254151,35753.32568612457,31111.372912801486
151,Mohawk Valley,4767,2640,2127,47275.966016362494,43723.06060606061,51685.778091208274,1659,977,682,80400.61482820977,68182.41555783009,97903.81231671554,2156,1116,1040,29044.874768089056,27124.910394265233,31105.14423076923,952,547,405,30839.453781512606,33899.9268738574,26705.925925925927
152,New York City,742979,430708,312271,58127.07138155991,60687.150092405995,54596.01540328753,332705,176216,156489,82498.2641769736,89933.89902165525,74125.29336247276,325716,195609,130107,40218.01023284088,42593.74642271061,36646.21639881021,84558,58883,25675,31220.688332268976,33268.15800825365,26525.024965920155
153,North Country,2509,892,1617,75995.65563969708,101771.86098654708,61776.49969078541,1653,672,981,99271.99032062916,125654.31547619047,81199.69418960245,716,127,589,30721.368715083798,28667.716535433072,31164.176570458403,140,93,47,32714.285714285714,29032.25806451613,40000.0
154,Southern Tier,7181,4525,2656,88801.33964628882,119392.18121546961,36684.03614457831,5553,3302,2251,100984.24635332252,142644.91823137493,39872.05686361617,1527,1122,405,40515.97904387688,48295.098039215685,18964.938271604937,101,101,0,149000.0,149000.0,0.0
155,Western NY,12948,7942,5006,60361.28467717022,65508.2863258625,52195.58609668398,6353,3460,2893,92616.94538013537,108721.80635838151,73355.68752160388,5520,4144,1376,29934.61231884058,31146.08108108108,26286.11918604651,1075,338,737,25975.25581395349,44437.869822485205,17508.005427408414
