,puma,Total_geo,Total_geo_m,Total_geo_f,Total_Avg_PINCP_mf_t,Total_Avg_PINCP_m,Total_Avg_PINCP_f,Total_BABS,Total_BABS_m,Total_BABS_f,BABS_Avg_PINCP_mf_t,BABS_Avg_PINCP_m,BABS_Avg_PINCP_f,Total_HS,Total_HS_m,Total_HS_f,HS_Avg_PINCP_mf_t,HS_Avg_PINCP_m,HS_Avg_PINCP_f,Total_HSINC,Total_HSINC_m,Total_HSINC_f,HSINC_Avg_PINCP_mf_t,HSINC_Avg_PINCP_m,HSINC_Avg_PINCP_f
0,Total Geo,1120846,661327,459519,68280.26024270953,73958.30373173936,60108.577534334814,510315,270339,239976,96788.20918452328,111300.37271721801,80439.89194752809,486370,299320,187050,46515.46497933672,51057.90031404517,39246.59705960973,124161,91668,32493,36367.73946730455,38608.248789108526,30046.900870956822
1,Monroe County (Central)--Rochester City (East) PUMA,1436,1051,385,54518.96935933147,59844.81446241675,39980.103896103894,616,507,109,80975.38961038961,84218.73767258383,65889.35779816513,636,544,92,35783.96226415094,37128.67647058824,27832.608695652172,184,0,184,30705.434782608696,0.0,30705.434782608696
2,NYC-Brooklyn Community District 4--Bushwick PUMA,9270,5895,3375,48125.606256742176,51144.88888888889,42851.92592592593,2593,1108,1485,67529.11685306595,69628.15884476535,65962.96296296296,4752,3303,1449,46973.39436026936,56120.2906448683,26123.015873015873,1925,1484,441,24833.14285714286,26270.754716981133,19995.46485260771
3,NYC-Manhattan Community District 10--Central Harlem PUMA,12051,8074,3977,64805.90490415733,68211.53083973247,57891.893386975105,5144,3672,1472,81816.64074650078,71850.5174291939,106677.78532608696,4975,2968,2007,47667.15175879397,62354.4474393531,25947.22471350274,1932,1434,498,63647.5569358178,71015.89958158995,42430.28112449799
4,Ontario & Yates Counties PUMA,503,382,121,59522.0675944334,56933.50785340314,67694.21487603306,280,233,47,78916.42857142857,67200.0,137000.0,174,149,25,38597.70114942529,40879.19463087248,25000.0,49,0,49,23000.0,0.0,23000.0
5,Albany County (Outside Albany City) PUMA,5517,3780,1737,81074.87221315932,82817.13492063493,77283.41968911917,4050,3011,1039,93149.4,89404.89870474926,104000.88546679499,1241,543,698,44053.82755842063,52461.178637200734,37513.43839541548,226,226,0,67983.18584070797,67983.18584070797,0.0
6,"Otsego, Schoharie, Oneida (South) & Herkimer (South) Counties PUMA",891,694,197,78447.25028058361,82608.64553314121,63787.30964467005,339,242,97,65464.601769911504,64307.438016528926,68351.54639175258,552,452,100,86420.28985507246,92407.0796460177,59360.0,0,0,0,#DIV/0!,0.0,0.0
7,NYC-Brooklyn Community District 11--Bensonhurst & Bath Beach PUMA,28591,17994,10597,59097.43765520618,59537.09569856619,58350.886099839576,14578,8323,6255,69450.18109480038,69837.99110897513,68934.15507593926,11120,7333,3787,50481.98741007194,54196.24982953771,43289.8336414048,2893,2338,555,40045.07431731766,39618.39178785287,41842.52252252252
8,"Rockland County (South)--Orangetown, Clarkstown (South) & Ramapo (Southeast) Towns PUMA",8107,4581,3526,76034.10386086098,88130.60030561013,60318.2643221781,4055,1582,2473,86768.65598027127,113600.56890012643,69604.04367165387,1763,1425,338,117143.60748723766,131372.05614035088,57156.80473372781,2289,1574,715,25354.914809960683,23383.10038119441,29695.664335664336
9,Warren & Washington Counties PUMA,282,219,63,73019.85815602836,84852.05479452055,31888.88888888889,132,132,0,129704.54545454546,129704.54545454546,0.0,150,87,63,23137.333333333332,16800.0,31888.88888888889,0,0,0,#DIV/0!,0.0,0.0
10,Erie County (North Central) PUMA,5217,3324,1893,60625.397738163694,74326.56438026474,36566.930797675646,3818,2358,1460,71434.88737558931,91650.63613231553,38785.068493150684,998,565,433,29282.364729458917,29431.504424778763,29087.759815242494,401,401,0,35711.97007481297,35711.97007481297,0.0
11,"NYC-Manhattan Community District 4 & 5--Chelsea, Clinton & Midtown Business District PUMA",18056,10186,7870,126102.44960124059,134722.31003337915,114945.91867852605,15473,8299,7174,136699.53014929232,151834.97409326426,119190.6021745191,2497,1887,610,63263.91670004005,59461.049284578694,75027.86885245901,86,0,86,44000.0,0.0,44000.0
12,Nassau County (Southeast)--Oyster Bay Town (South) PUMA,984,653,331,59721.544715447155,68456.35528330781,42489.425981873115,360,360,0,93335.55555555556,93335.55555555556,0.0,516,185,331,42720.93023255814,43135.13513513513,42489.425981873115,108,108,0,28900.0,28900.0,0.0
13,Nassau County (Central)--Hempstead Town (Northeast) PUMA,9928,5948,3980,67903.06204673651,74334.83523873572,58290.95477386934,6128,2834,3294,81605.38511749347,102336.20324629499,63769.581056466304,1919,1833,86,56908.59822824388,56528.96890343699,65000.0,1881,1281,600,34479.638490164805,37865.105386416864,27251.666666666668
14,NYC-Brooklyn Community District 16--Brownsville & Ocean Hill PUMA,2845,1565,1280,35107.55711775044,38980.255591054316,30372.578125,458,334,124,47660.262008733625,57964.071856287424,19906.451612903227,2129,1231,898,33300.3287928605,33829.48822095857,32574.944320712693,258,0,258,27737.20930232558,0.0,27737.20930232558
15,NYC-Brooklyn Community District 2--Brooklyn Heights & Fort Greene PUMA,7924,3908,4016,93593.00605754669,119159.87717502558,68713.69023904382,5918,3139,2779,110393.03480905712,136818.8595093979,80543.92947103275,1102,343,759,58294.373865698726,78024.48979591837,49378.12911725955,904,426,478,26642.256637168142,22159.62441314554,30637.23849372385
16,Onondaga County (Central)--Syracuse City PUMA,2948,1719,1229,40270.810719131616,42243.31006399069,37511.879576891784,1216,749,467,58639.76151315789,61245.8611481976,54459.95717344754,1280,760,520,28882.109375,27792.105263157893,30475.19230769231,452,210,242,23104.646017699117,26767.14285714286,19926.446280991735
17,NYC-Staten Island Community District 2--New Springville & South Beach PUMA,16829,10129,6700,74978.26668251233,80268.05212755455,66981.21641791044,8732,4465,4267,92633.05657352267,106258.76819708846,78375.07616592453,7209,5260,1949,57458.01081980857,59274.08745247148,52556.74704976911,888,404,484,43606.53153153153,66356.43564356436,24616.942148760332
18,Nassau County (West Central)--Hempstead Town (Northwest) PUMA,7691,4104,3587,67272.51332726564,75462.15886939572,57902.48118204628,2945,1275,1670,83466.14601018676,92263.8431372549,76749.34131736527,4275,2715,1560,58792.538011695906,66331.60220994476,45671.666666666664,471,114,357,42987.261146496814,105000.0,23184.873949579833
19,"NYC-Manhattan Community District 9--Hamilton Heights, Manhattanville & West Harlem PUMA",10253,6224,4029,74734.6971618063,87762.49196658097,54609.35716058575,5488,3376,2112,110810.9056122449,130711.53732227487,79000.04734848485,3463,1546,1917,32984.57984406584,39490.68564036222,27737.610850286906,1302,1302,0,33716.589861751156,33716.589861751156,0.0
20,Monroe County (Central)--Rochester City (West) PUMA,2573,1583,990,40370.07384376215,47144.09349336702,29538.484848484848,800,596,204,54899.625,61248.82550335571,36350.0,1359,829,530,29837.159676232524,30722.557297949337,28452.264150943396,414,158,256,46869.08212560386,80100.0,26359.375
21,"Chenango, Delaware & Broome (East) Counties PUMA",425,272,153,53245.74117647059,61949.779411764706,37771.8954248366,170,170,0,53316.705882352944,53316.705882352944,0.0,218,102,116,61497.706422018346,76338.23529411765,48448.275862068964,37,0,37,4300.0,0.0,4300.0
22,Dutchess County (North & East) PUMA,2046,1339,707,63788.26979472141,62348.99178491411,66514.14427157001,1149,849,300,84822.19321148825,79892.4617196702,98773.33333333333,483,145,338,44148.24016563147,39259.31034482759,46245.56213017752,414,345,69,28324.87922705314,28881.159420289856,25543.478260869564
23,NYC-Brooklyn Community District 10--Bay Ridge & Dyker Heights PUMA,13266,8085,5181,68093.5240464345,67648.90043290044,68787.36344335071,7078,3852,3226,89085.1709522464,88740.23883696781,89497.03657780534,5115,3514,1601,45481.49560117302,49626.79567444508,36383.06683322923,1073,719,354,37414.72506989748,42733.518776077886,26611.86440677966
24,NYC-Brooklyn Community District 1--Greenpoint & Williamsburg PUMA,9597,5532,4065,83582.61331666146,98698.74005784527,63011.293972939726,5291,2458,2833,111515.34303534303,156590.9479251424,72406.32897987998,3469,2546,923,53066.58402997982,55180.75412411626,47234.86457204767,837,528,309,33484.68339307049,39035.378787878784,24000.0
25,NYC-Brooklyn Community District 18--Canarsie & Flatlands PUMA,14991,6981,8010,66813.71622973784,78404.24008021773,56712.16229712859,7185,3576,3609,77225.63952679193,83163.5067114094,71342.06705458576,7113,2965,4148,57739.94095318431,75080.37099494098,45344.961427193826,693,440,253,51997.113997114,62122.72727272727,34387.35177865613
26,Westchester County (Southeast) PUMA,13868,8981,4887,88131.15085087973,85278.7317670638,93373.13484755474,5269,2809,2460,155869.99620421333,162562.299750801,148228.25609756098,5517,3148,2369,54756.3150262824,67247.01080050826,38158.29463908822,3082,3024,58,32067.878001297857,32260.978835978836,22000.0
27,Nassau County (Central)--Hempstead Town (North Central)--Meadowbrook Corridor PUMA,10584,7045,3539,49225.633030990175,52868.99929027679,41972.87369313365,2659,1422,1237,71465.51335088379,82959.91561181434,58252.06143896524,5509,3828,1681,47720.4755854057,52386.389759665624,37095.18143961927,2416,1795,621,28180.960264900663,30060.16713091922,22749.114331723027
28,Westchester County (Northwest) PUMA,12309,7457,4852,70640.10561377853,80549.37642483572,55410.62654575433,3969,2024,1945,130020.94734189972,157041.1561264822,101903.25964010283,5736,3734,2002,47754.449093444906,59234.868773433314,26341.91808191808,2604,1699,905,30543.93241167435,36269.80576809888,19794.475138121546
29,Monroe County (South) PUMA,4952,3150,1802,89206.69224555735,84133.15555555555,98075.52719200889,3529,2376,1153,111388.59166902806,101042.94612794612,132707.97918473548,1423,774,649,34196.205200281096,32224.03100775194,36548.228043143296,0,0,0,#DIV/0!,0.0,0.0
30,Rockland County (North)--New City & Congers PUMA,6114,3132,2982,74143.78148511612,83201.49425287357,64630.44936284373,2477,1000,1477,95558.09446911587,96417.4,94976.30331753555,3285,1780,1505,62702.4901065449,86252.62921348315,34849.16943521595,352,352,0,30227.272727272728,30227.272727272728,0.0
31,"NYC-Bronx Community District 1 & 2--Hunts Point, Longwood & Melrose PUMA",9895,5689,4206,32784.56796361799,34649.3935665319,30262.220637184975,1526,514,1012,46507.732634338136,56060.31128404669,41655.928853754944,6588,4040,2548,31551.32058287796,34837.72277227723,26340.541601255885,1781,1135,646,25588.09657495789,24282.819383259914,27881.42414860681
32,Orange County (Southeast) PUMA,3863,1791,2072,84890.21485891794,93669.29089893914,77301.73745173746,1966,721,1245,102433.16378433368,109596.94868238557,98284.49799196787,1344,959,385,77277.90178571429,89794.05630865485,46101.2987012987,553,111,442,41023.14647377939,23691.891891891893,45375.565610859725
33,"NYC-Queens Community District 12--Jamaica, Hollis & St. Albans PUMA",17540,11782,5758,49921.844355758265,51965.50670514344,45740.10941299062,6375,3698,2677,61383.623529411765,60615.84640346133,62444.228614120286,9250,6602,2648,44184.03243243243,48977.08270221145,32233.987915407855,1915,1482,433,39481.07049608355,43693.31983805668,25064.087759815244
34,Nassau County (Northeast)--Oyster Bay Town (North) & Glen Cove City PUMA,8589,4795,3794,97830.88135987891,117374.04379562044,73131.49710068529,5276,2966,2310,130533.80212282031,163395.69790964262,88339.69696969698,2215,788,1427,53682.12189616253,59851.142131979694,50275.54309740715,1098,1041,57,29751.548269581057,29792.699327569644,29000.0
35,"Rockland County (West)--Spring Valley, Suffern Villages & Monsey PUMA",7261,3917,3344,57284.62195289905,70224.12560633138,42127.91267942584,2435,894,1541,71037.74127310062,114931.65548098434,45573.00454250487,3776,2185,1591,51514.76165254237,58098.855835240276,42472.495285983656,1050,838,212,46140.0,54144.391408114556,14500.0
36,NYC-Queens Community District 2--Sunnyside & Woodside PUMA,23879,14696,9183,59929.758783868674,66794.04259662493,48944.5126864859,11244,5831,5413,81246.92369263608,105512.59646715829,55107.419176057636,11614,8226,3388,41426.390563113484,41202.29759299781,41970.48406139315,1021,639,382,35647.60039177277,42928.3255086072,23468.586387434556
37,Suffolk County (Northwest)--Huntington Town (South) PUMA,4918,3233,1685,87964.03416022773,80253.14568512217,102758.87240356083,3345,2280,1065,110286.03886397608,98788.64035087719,134900.18779342723,1290,755,535,40058.38759689922,32212.344370860927,51130.84112149533,283,198,85,42491.16607773852,50000.0,25000.0
38,Westchester County (Southwest)--Yonkers City PUMA,16596,9689,6907,57291.72993492408,61650.38187635463,51177.50108585493,5472,2893,2579,90295.23940058479,98978.4825440719,80554.78867778208,9186,5164,4022,43613.67298062269,50160.92176607281,35207.409249129785,1938,1632,306,28938.493292053663,31835.049019607843,13490.196078431372
39,"NYC-Manhattan Community District 1 & 2--Battery Park City, Greenwich Village & Soho PUMA",11375,6742,4633,176616.37186813186,217324.9080391575,117376.79689186273,10518,5885,4633,186052.37022247576,240117.60917587086,117376.79689186273,314,314,0,119271.97452229299,119271.97452229299,0.0,543,543,0,27000.0,27000.0,0.0
40,NYC-Brooklyn Community District 14--Flatbush & Midwood PUMA,14605,8828,5777,56065.507702841496,57306.415949252376,54169.240090012114,5805,3062,2743,70772.94401378122,75293.54670150229,65726.61319722931,7801,5122,2679,48322.33047045251,50031.41351034752,45054.72191116088,999,644,355,31068.368368368367,29644.875776397515,33650.704225352114
41,NYC-Queens Community District 9--Richmond Hill & Woodhaven PUMA,19130,12623,6507,56163.44119184527,58930.51572526341,50795.56323958813,7651,4531,3120,72850.3947196445,78628.54557492827,64459.11217948718,9221,6189,3032,48086.20106279146,51899.993536920345,40301.3852242744,2258,1903,355,32606.465899025687,34894.85023646873,20339.436619718308
42,Erie County (West Central)--Buffalo City (West) PUMA,2977,1699,1278,46954.48438024857,51942.20129487934,40323.7089201878,1414,686,728,75045.26166902404,96924.19825072886,54428.57142857143,866,718,148,19012.00923787529,19684.122562674096,15751.351351351352,697,295,402,24684.505021520803,25852.881355932204,23827.114427860695
43,Fulton & Montgomery Counties PUMA,681,504,177,62559.66226138033,70581.60714285714,39717.51412429378,200,114,86,35480.0,24526.315789473683,50000.0,481,390,91,73819.39708939708,84043.92307692308,30000.0,0,0,0,#DIV/0!,0.0,0.0
44,Westchester County (Central)--White Plains City PUMA,14362,7776,6586,93155.9727057513,99456.06738683127,85717.53720012147,7016,2942,4074,136818.70724059292,173796.78789938817,110115.3411880216,4994,2978,2016,48737.63115738887,46556.39019476158,51959.72222222222,2352,1856,496,57223.76700680272,66495.3125,22530.24193548387
45,St. Lawrence County PUMA,631,278,353,66332.07606973058,73238.12949640288,60893.31444759207,596,260,336,68213.9932885906,77616.15384615384,60938.51190476191,35,18,17,34285.71428571428,10000.0,60000.0,0,0,0,#DIV/0!,0.0,0.0
46,Saratoga County (South & Central) PUMA,3503,1851,1652,113668.65543819583,114924.7433819557,112261.25907990315,2679,1436,1243,135267.52519596866,141942.6183844011,127555.99356395817,666,257,409,45449.84984984985,13097.665369649805,65778.72860635696,158,158,0,35000.0,35000.0,0.0
47,Suffolk County (Central)--Brookhaven Town (West Central) PUMA,3124,1985,1139,74416.0371318822,69049.6725440806,83768.30553116769,1729,928,801,95875.41931752457,84710.77586206897,108810.23720349564,1173,928,245,50775.78857630009,57760.775862068964,24318.367346938776,222,129,93,32194.144144144146,37596.8992248062,24700.0
48,Suffolk County (North Central)--Brookhaven Town (North) PUMA,3691,1815,1876,133610.56895150366,187459.39944903582,81512.68656716419,3232,1733,1499,148626.24071782178,195383.0409694172,94570.51367578386,459,82,377,27879.302832244008,20000.0,29593.103448275862,0,0,0,#DIV/0!,0.0,0.0
49,Niagara County (Southwest)--Greater Niagara Falls & North Tonawanda Area PUMA,314,229,85,43629.61783439491,52400.43668122271,20000.0,0,0,0,#DIV/0!,0.0,0.0,314,229,85,43629.61783439491,52400.43668122271,20000.0,0,0,0,#DIV/0!,0.0,0.0
50,Suffolk County (Central)--Islip Town (East) PUMA,1925,999,926,62185.76623376623,85749.74974974975,36764.14686825054,776,345,431,76525.77319587629,101808.69565217392,56287.7030162413,809,314,495,44343.139678615575,83089.1719745223,19764.848484848484,340,340,0,71911.76470588235,71911.76470588235,0.0
51,"NYC-Brooklyn Community District 9--Crown Heights South, Prospect Lefferts & Wingate PUMA",6404,2816,3588,48140.615240474704,65360.333806818184,34625.91973244147,1600,1090,510,57152.5,55384.40366972477,60931.37254901961,4299,1435,2864,47714.0032565713,80108.50174216028,31482.821229050278,505,291,214,23219.80198019802,30000.0,14000.0
52,Westchester County (Northeast) PUMA,5744,3656,2088,111933.96935933147,132392.9978118162,76111.07279693487,3404,1741,1663,146417.60282021153,214839.6323951752,74786.36199639206,2092,1667,425,65536.90248565965,61519.49610077984,81294.58823529411,248,248,0,30000.0,30000.0,0.0
53,Chautauqua County PUMA,527,266,261,55962.42884250474,29429.323308270676,83003.83141762452,118,54,64,174881.35593220338,55000.0,276031.25,271,212,59,24022.878228782287,22916.037735849055,28000.0,138,0,138,17000.0,0.0,17000.0
54,Erie County (West Central)--Buffalo City (East) PUMA,2022,1692,330,32791.59248269041,31061.820330969265,41660.606060606064,522,339,183,38768.96551724138,43852.50737463127,29351.912568306012,1159,1012,147,31840.120793787748,28187.845849802372,56983.67346938775,341,341,0,26875.366568914957,26875.366568914957,0.0
55,Cayuga & Onondaga (South) Counties PUMA,721,296,425,93405.64493758668,128352.12837837837,69066.44705882353,617,282,335,104790.06482982171,133483.085106383,80636.53731343284,0,0,0,#DIV/0!,0.0,0.0,104,14,90,25865.384615384617,25000.0,26000.0
56,Oneida County (Central)--Greater Utica & Rome Cities PUMA,3751,2039,1712,52686.23033857638,61115.64492398234,42646.7581775701,881,502,379,64902.83768444949,89401.593625498,32453.298153034302,2130,1080,1050,57143.16901408451,62539.53703703704,51592.619047619046,740,457,283,25313.108108108107,26679.431072210067,23106.713780918726
57,Suffolk County (Southwest)--Babylon Town (Southeast) PUMA,3846,2541,1305,55336.29745189808,57775.285320739866,50587.27969348659,1200,581,619,67685.0,75308.08950086059,60529.88691437803,2179,1545,634,47368.517668655346,49445.95469255663,42305.993690851734,467,415,52,60782.441113490364,64238.55421686747,33200.0
58,"NYC-Manhattan Community District 6--Murray Hill, Gramercy & Stuyvesant Town PUMA",12553,6218,6335,128296.59045646459,149117.75490511418,107859.9684293607,10720,5212,5508,142434.0485074627,168287.22179585573,117970.22512708788,1697,870,827,47252.15085444903,53648.275862068964,40523.45828295042,136,136,0,25200.0,25200.0,0.0
59,NYC-Manhattan Community District 11--East Harlem PUMA,8460,4591,3869,58895.79196217494,49924.308429536046,69541.45774101836,3944,2280,1664,75747.51521298174,60182.32456140351,97074.81971153847,2945,946,1999,47450.52631578947,42253.06553911205,49910.155077538766,1571,1365,206,38044.812221514956,38106.520146520146,37635.922330097084
60,Schenectady County--Schenectady City PUMA,1236,1039,197,69322.33009708738,70574.9759384023,62715.73604060914,715,663,52,92838.18181818182,89845.09803921569,131000.0,521,376,145,37050.095969289825,36596.01063829787,38227.58620689655,0,0,0,#DIV/0!,0.0,0.0
61,"Clinton, Franklin, Essex & Hamilton Counties PUMA",604,333,271,79674.00662251655,89567.26726726726,67517.34317343173,505,333,172,88276.23762376238,89567.26726726726,85776.74418604652,26,0,26,88000.0,0.0,88000.0,73,0,73,17200.0,0.0,17200.0
62,Onondaga County (Central)--Syracuse City (Outer) PUMA,2021,1027,994,83059.30727362692,111532.52190847127,53640.80482897384,1458,862,596,102469.13580246913,127310.32482598608,66541.10738255034,433,165,268,36542.401847575056,29105.454545454544,41121.119402985074,130,0,130,20307.69230769231,0.0,20307.69230769231
63,"NYC-Queens Community District 11--Bayside, Douglaston & Little Neck PUMA",11371,5892,5479,72894.55896579017,86039.89307535642,58758.34641357912,5124,2591,2533,103216.76034348166,122377.8849864917,83616.88906435057,5279,2696,2583,46570.20268990339,56934.23590504451,35752.76809910956,968,605,363,55947.57231404959,60117.76859504132,48997.245179063364
64,"NYC-Staten Island Community District 3--Tottenville, Great Kills & Annadale PUMA",9944,5350,4594,75068.3930008045,83547.96261682243,65193.40444057466,5315,2809,2506,91513.26434619003,100315.62833748665,81646.6081404629,3608,2050,1558,54173.89135254989,62273.07317073171,43517.07317073171,1021,491,530,63298.43290891283,76446.43584521385,51117.92452830189
65,Onondaga County (North) PUMA,1406,253,1153,39262.58890469417,69407.11462450594,32648.048568950562,278,81,197,71483.45323741007,90000.0,63870.05076142132,896,67,829,28931.696428571428,100000.0,23187.937273823885,232,105,127,40551.724137931036,34000.0,45968.503937007874
66,Ulster County (East) PUMA,2779,1236,1543,49967.362360561354,50991.100323624596,49147.310434219056,1248,587,661,64183.41346153846,63328.79045996593,64942.36006051437,1290,524,766,35705.73643410853,37253.81679389313,34646.7362924282,241,125,116,52688.79668049792,50640.0,54896.55172413793
67,Oswego County PUMA,260,260,0,130388.61538461539,130388.61538461539,0.0,144,144,0,210000.0,210000.0,0.0,51,51,0,43745.882352941175,43745.882352941175,0.0,65,65,0,22000.0,22000.0,0.0
68,Niagara County (North & East) PUMA,442,232,210,28369.909502262442,29594.827586206895,27016.666666666668,214,214,0,30233.644859813085,30233.644859813085,0.0,228,18,210,26620.614035087718,22000.0,27016.666666666668,0,0,0,#DIV/0!,0.0,0.0
69,Broome (Outer West) & Tioga Counties PUMA,583,277,306,51702.52144082333,58843.21299638989,45238.56209150327,468,277,191,51507.6282051282,58843.21299638989,40869.10994764398,115,0,115,52495.65217391304,0.0,52495.65217391304,0,0,0,#DIV/0!,0.0,0.0
70,"NYC-Bronx Community District 4--Concourse, Highbridge & Mount Eden PUMA",13482,7566,5916,34029.36507936508,36801.38778747026,30484.2123056119,3409,1583,1826,42730.008800234675,41090.84017687934,44151.04052573932,7092,4367,2725,35368.344613649184,38797.687199450425,29872.5871559633,2981,1616,1365,20893.9953035894,27204.826732673268,13422.710622710623
71,Suffolk County (Southwest)--Islip Town (South) PUMA,4912,2876,2036,60948.153501628665,69692.42350486787,48596.2278978389,1754,1047,707,81988.5518814139,107828.08022922635,43722.659123055164,2385,1336,1049,52653.840670859536,47783.989520958086,58856.05338417541,773,493,280,38796.895213454074,48073.02231237323,22464.285714285714
72,Erie County (Central) PUMA,1097,782,315,49067.82133090246,51930.9462915601,41960.0,475,260,215,68057.47368421052,85730.76923076923,46685.11627906977,483,430,53,34919.25465838509,34046.51162790698,42000.0,139,92,47,33338.84892086331,40000.0,20300.0
73,"NYC-Bronx Community District 8--Riverdale, Fieldston & Kingsbridge PUMA",8562,4613,3949,60303.055360896986,67894.29872100585,51435.391238288175,4185,1749,2436,82635.16367980884,103728.1875357347,67490.7881773399,3030,1517,1513,41003.56435643564,56381.01516150297,25585.45935228024,1347,1347,0,34332.44246473645,34332.44246473645,0.0
74,Chemung (South) & Steuben (East) Counties--Greater Elmira & Greater Corning Cities PUMA,1652,1227,425,141775.1573849879,153460.9290953545,108037.64705882352,1269,844,425,180082.2379826635,216360.61611374406,108037.64705882352,383,383,0,14851.697127937337,14851.697127937337,0.0,0,0,0,#DIV/0!,0.0,0.0
75,Nassau County (South Central)--Hempstead Town (Southeast) PUMA,5071,3288,1783,58855.56103332676,60086.11618004866,56586.31519910264,2101,1228,873,76087.81532603523,74484.9348534202,78342.49713631158,2203,1484,719,56153.60871538811,63500.0,40990.82058414465,767,576,191,19412.84224250326,20593.14236111111,15853.403141361257
76,"NYC-Queens Community District 13--Queens Village, Cambria Heights & Rosedale PUMA",18770,10635,8135,57611.63452317528,54420.532204983545,61783.40749846343,6747,2558,4189,68484.20334963688,57550.55512118843,75160.80210074004,9676,6348,3328,54055.58081852005,56324.87397605545,49727.013221153844,2347,1729,618,41016.47209203238,42797.998843262,36032.23300970874
77,Cattaraugus & Allegany Counties PUMA,352,210,142,50503.40909090909,42072.380952380954,62971.83098591549,171,29,142,71795.3216374269,115000.0,62971.83098591549,55,55,0,50520.0,50520.0,0.0,126,126,0,21600.0,21600.0,0.0
78,"NYC-Queens Community District 7--Flushing, Murray Hill & Whitestone PUMA",30515,17456,13059,55645.62313616254,59123.555797433546,50996.661306378744,13536,7965,5571,76127.24143026005,84792.81230382925,63737.8549632023,14879,8243,6636,40272.39397808992,38922.011403615186,41949.79053646775,2100,1248,852,32549.95238095238,28727.483974358973,38149.06103286385
79,Jefferson & Lewis Counties PUMA,1219,318,901,29811.40278917145,34553.45911949685,28137.735849056604,522,318,204,40513.40996168582,34553.45911949685,49803.92156862745,697,0,697,21796.41319942611,0.0,21796.41319942611,0,0,0,#DIV/0!,0.0,0.0
80,"NYC-Brooklyn Community District 6--Park Slope, Carroll Gardens & Red Hook PUMA",5474,3854,1620,113614.90683229813,125983.65334717177,84189.50617283951,3812,2656,1156,131992.83840503672,146017.8840361446,99769.20415224913,1239,948,291,80741.16222760291,92837.02531645569,41336.0824742268,423,250,173,44286.05200945627,38832.0,52167.63005780347
81,NYC-Queens Community District 1--Astoria & Long Island City PUMA,19245,10735,8510,59235.51000259808,62110.20307405682,55609.207990599294,10177,4672,5505,71045.08794340178,77319.97003424658,65719.70208901,8233,5273,2960,47379.41576582048,53142.48625071117,37112.97297297297,835,790,45,32199.760479041917,32017.46835443038,35400.0
82,Saratoga County (Outer) PUMA,663,612,51,81864.25339366516,80352.94117647059,100000.0,459,408,51,104915.03267973856,105529.41176470589,100000.0,53,53,0,30000.0,30000.0,0.0,151,151,0,30000.0,30000.0,0.0
83,Dutchess County (Southwest) PUMA,8702,5126,3576,80075.38381981154,87174.92976980102,69898.57382550335,3653,1942,1711,119917.38297289898,130179.29969104017,108270.01753360608,4303,2817,1486,54846.56983499884,65197.19204827831,35224.9663526245,746,367,379,30500.0,28310.626702997277,32620.05277044855
84,Erie County (Northwest) PUMA,1805,1220,585,62636.703601108034,69911.68032786885,47464.957264957266,902,632,270,59480.321507760535,57676.02848101266,63703.7037037037,903,588,315,65789.59025470653,83062.92517006803,33546.031746031746,0,0,0,#DIV/0!,0.0,0.0
85,Genesee & Orleans Counties PUMA,404,404,0,43379.70297029703,43379.70297029703,0.0,239,239,0,29000.0,29000.0,0.0,29,29,0,28600.0,28600.0,0.0,136,136,0,71801.4705882353,71801.4705882353,0.0
86,Erie County (Northeast) PUMA,529,350,179,93368.62003780718,120217.14285714286,40871.50837988827,529,350,179,93368.62003780718,120217.14285714286,40871.50837988827,0,0,0,#DIV/0!,0.0,0.0,0,0,0,#DIV/0!,0.0,0.0
87,"NYC-Queens Community District 5--Ridgewood, Glendale & Middle Village PUMA",24754,15500,9254,55212.60685141795,55714.993548387094,54371.13356386428,9055,5376,3679,70723.27112092766,70755.43154761905,70676.27616200055,12776,8005,4771,46171.646055103316,47228.85696439725,44397.80968350451,2923,2119,804,46679.678412589805,49615.00707881076,38943.407960199
88,NYC-Brooklyn Community District 3--Bedford-Stuyvesant PUMA,4992,2857,2135,63637.74038461538,54814.20371018551,75445.16159250586,2509,1352,1157,93599.02750099641,81401.28698224852,107852.56698357822,1377,929,448,30212.08424110385,25330.075349838535,40335.71428571428,1106,576,530,37285.35262206148,39961.805555555555,34376.6037735849
89,Nassau County (West Central)--Hempstead Town (West Central) PUMA,9462,5515,3947,70277.96026210104,70413.20036264733,70088.99417278946,4810,2329,2481,91506.0291060291,99135.6805495921,84343.81297863765,4176,2817,1359,49201.259578544064,50498.11856585019,46513.06843267108,476,369,107,40675.63025210084,41161.517615176155,39000.0
90,Suffolk County (South Central)--Brookhaven Town (South) PUMA,4484,2835,1649,51550.27876895629,69344.00352733686,20958.884172225593,925,595,330,104315.2972972973,141900.25210084033,36548.48484848485,2224,1174,1050,32976.25899280576,46603.57751277683,17739.619047619046,1335,1066,269,45933.03370786517,53890.243902439026,14400.0
91,Orange County (Northeast)--Greater Newburgh City PUMA,5003,2852,2151,69730.07395562662,80253.07854137447,55777.67549976755,1974,1017,957,101527.54812563323,130467.33529990168,70773.35423197492,1938,1133,805,56525.892672858616,61016.328331862314,50205.81366459627,1091,702,389,35652.612282309805,38554.13105413105,30416.45244215938
92,Sullivan & Ulster (West) Counties PUMA,3027,1208,1819,64893.09547406673,82706.04304635762,53063.49642660803,1638,410,1228,88199.57264957266,164813.17073170733,62620.11400651466,1215,624,591,37287.654320987655,41153.044871794875,33206.42978003384,174,174,0,38252.87356321839,38252.87356321839,0.0
93,"NYC-Staten Island Community District 1--Port Richmond, Stapleton & Mariner's Harbor PUMA",12207,7415,4792,58082.50266240681,63338.78894133513,49949.07971619366,6034,3668,2366,67283.76201524693,69111.67393675027,64449.957734573116,4621,2785,1836,41787.29495780134,43047.648114901254,39875.48474945534,1552,962,590,70827.19072164949,100070.47817047816,23145.762711864405
94,Wayne & Seneca Counties PUMA,1602,1037,565,56053.74531835206,62946.576663452266,43402.654867256635,417,234,183,66760.19184652278,78940.17094017094,51185.79234972678,949,567,382,54548.47207586934,64569.664902998236,39674.08376963351,236,236,0,43188.983050847455,43188.983050847455,0.0
95,Albany County (East Central)--Albany City PUMA,2777,1409,1368,53758.318329132155,62912.84599006388,44329.42251461988,1554,601,953,65595.14157014157,87349.75041597338,51875.81322140608,1223,808,415,38717.90678659035,44736.38613861386,27000.0,0,0,0,#DIV/0!,0.0,0.0
96,Nassau County (Northwest)--North Hempstead Town (North) PUMA,8109,5012,3097,161629.92477494144,173993.83280127693,141620.91378753632,6299,3506,2793,182887.37736148594,206423.1660011409,153343.34765485142,1453,1241,212,101984.63179628355,111319.63738920225,47339.622641509435,357,265,92,29315.96638655462,38452.07547169811,3000.0
97,Rensselaer County--Troy City PUMA,1848,1010,838,49435.27597402597,52656.32673267327,45553.10262529833,839,480,359,50431.692491060785,60320.1875,37210.30640668524,710,406,304,58638.30985915493,53924.137931034486,64934.21052631579,299,124,175,24785.953177257525,18838.709677419356,29000.0
98,Tompkins County PUMA,3297,1679,1618,61576.55444343342,61046.337105419894,62126.761433868975,3055,1679,1376,64644.81178396072,61046.337105419894,69035.68313953489,186,0,186,17376.344086021505,0.0,17376.344086021505,56,0,56,41000.0,0.0,41000.0
99,Suffolk County (West Central)--Babylon Town (Northwest) PUMA,8945,5722,3223,57020.760201229736,55015.25690318071,60581.25969593546,2711,1448,1263,80680.70822574696,72954.69613259668,89538.40063341252,5150,3231,1919,48831.16504854369,52717.703497369235,42287.44137571652,1084,1043,41,36757.19557195572,37227.22914669223,24800.0
100,NYC-Queens Community District 3--Jackson Heights & North Corona PUMA,22700,15026,7674,46096.05242290749,46999.19406362305,44327.66484232473,5609,2749,2860,63302.69210197896,67499.92724627137,59268.356643356645,14347,10024,4323,40609.3113542901,42874.97905027933,35355.77145500809,2744,2253,491,39611.44314868805,40334.57612072792,36293.27902240326
101,NYC-Queens Community District 4--Elmhurst & South Corona PUMA,22894,15531,7363,43674.81436184153,41343.55804519992,48592.20426456608,8164,4643,3521,55227.70700636943,49427.0945509369,62876.73956262426,12886,9592,3294,38826.89740803973,39172.01834862385,37821.91863995143,1844,1296,548,26403.904555314533,28455.864197530864,21551.094890510947
102,Columbia & Greene Counties PUMA,1029,674,355,79845.57823129251,90219.43620178041,60149.859154929574,376,190,186,157323.93617021278,218177.8947368421,95161.29032258065,343,239,104,44241.39941690962,53483.6820083682,23001.923076923078,310,245,65,25266.129032258064,26822.448979591838,19400.0
103,Madison & Cortland Counties PUMA,446,159,287,113809.41704035875,200547.16981132075,65756.09756097561,159,159,0,200547.16981132075,200547.16981132075,0.0,287,0,287,65756.09756097561,0.0,65756.09756097561,0,0,0,#DIV/0!,0.0,0.0
104,NYC-Queens Community District 6--Forest Hills & Rego Park PUMA,21172,9141,12031,70458.18959002456,79302.98216825293,63738.02925775081,14135,6289,7846,82104.93031482137,92782.37557640324,73546.3713994392,6289,2195,4094,49007.6641755446,55986.28701594533,45266.07230092819,748,657,91,30719.786096256685,28173.972602739726,49100.0
105,NYC-Brooklyn Community District 5--East New York & Starrett City PUMA,12295,8543,3752,41226.539243594954,43820.44949081119,35320.4157782516,1780,1309,471,60623.93258426966,59537.20397249809,63644.16135881104,9267,6291,2976,40130.581633754184,44165.999046256555,31600.067204301075,1248,943,305,21698.397435897437,19698.409331919407,27881.967213114753
106,"NYC-Bronx Community District 5--Morris Heights, Fordham South & Mount Hope PUMA",14067,8403,5664,44374.00867278026,44972.39081280495,43486.26059322034,3990,1640,2350,52286.48621553885,51378.53658536585,52920.11914893617,7813,4783,3030,32558.223473697682,29509.575580179804,37370.6600660066,2264,1980,284,71205.25618374559,77019.14141414141,30671.830985915494
107,NYC-Brooklyn Community District 8--Crown Heights North & Prospect Heights PUMA,5546,2199,3347,54646.9347277317,67158.25375170531,46426.91962951897,2943,897,2046,75479.40876656472,123483.83500557413,54433.47996089931,2139,1185,954,32243.94576905096,29118.818565400845,36125.78616352201,464,117,347,25789.224137931036,20600.0,27538.904899135447
108,"Steuben (North & West), Schuyler & Chemung (North) Counties PUMA",490,379,111,28493.877551020407,28701.84696569921,27783.783783783783,159,66,93,40641.50943396227,58000.0,28322.58064516129,300,282,18,18800.0,18404.255319148935,25000.0,31,31,0,60000.0,60000.0,0.0
109,Herkimer (North & Central) & Oneida (Outer) Counties PUMA,828,598,230,56456.038647343,66923.07692307692,29241.739130434784,167,135,32,64431.1377245509,67851.85185185185,50000.0,463,265,198,59977.53779697624,85449.05660377358,25886.868686868685,198,198,0,41494.9494949495,41494.9494949495,0.0
110,Livingston & Wyoming Counties PUMA,109,109,0,39862.38532110092,39862.38532110092,0.0,0,0,0,#DIV/0!,0.0,0.0,56,56,0,35000.0,35000.0,0.0,53,53,0,45000.0,45000.0,0.0
111,Putnam County PUMA,3172,1394,1778,60843.095838587644,67941.17647058824,55278.00899887514,900,504,396,93768.33333333333,109642.85714285714,73564.39393939394,1956,574,1382,49114.41717791411,46890.243902439026,50038.20549927641,316,316,0,39667.72151898734,39667.72151898734,0.0
112,"NYC-Brooklyn Community District 17--East Flatbush, Farragut & Rugby PUMA",7299,3956,3343,44249.07137964105,42889.02224469161,45858.51032007179,2159,876,1283,53492.45020842983,56262.55707762557,51601.09119251754,4756,2696,2060,39738.051303616485,37794.27744807122,42281.94174757282,384,384,0,48150.0,48150.0,0.0
113,Suffolk County (Northwest)--Huntington Town (North) PUMA,4744,3659,1085,81599.76812816189,87484.50396283137,61754.37788018433,1570,1300,270,159347.89808917197,175233.84615384616,82860.0,2561,1818,743,45523.66263178446,41004.84048404841,56580.48452220727,613,541,72,33192.49592169657,32818.853974121994,36000.0
114,"NYC-Bronx Community District 12--Wakefield, Williamsbridge & Woodlawn PUMA",10871,6324,4547,50490.00459939288,52561.50221378874,47608.95095667473,2829,1393,1436,73893.1071049841,74551.04091888011,73254.87465181059,6459,3563,2896,44208.6917479486,50115.08279539714,36941.9544198895,1583,1368,215,34295.1989892609,36541.88596491228,20000.0
115,NYC-Manhattan Community District 3--Chinatown & Lower East Side PUMA,9890,5585,4305,60348.37917087968,55134.69471799463,67112.24157955866,5675,2934,2741,80876.01938325992,71343.83435582822,91079.38708500547,3444,1984,1460,33723.42044134727,39444.78830645161,25948.630136986303,771,667,104,28184.954604409857,30503.748125937032,13313.461538461539
116,Nassau County (East Central)--Oyster Bay Town (Central) PUMA,9312,5545,3767,84838.60180412371,94974.76284941389,69918.2373241306,5982,2941,3041,104641.7853560682,130710.35702142128,79430.45050970075,2963,2462,501,52402.39622004725,55842.52640129976,35497.00598802395,367,142,225,23928.065395095367,33321.126760563384,18000.0
117,Westchester County (South Central)--New Rochelle & Mount Vernon Cities PUMA,15010,8796,6214,79740.40306462359,83109.27694406548,74971.71709044094,4884,2637,2247,145235.82104832106,138033.37125521427,153688.36226079217,8154,4911,3243,50742.46995339711,63192.14009366728,31889.45420906568,1972,1248,724,37432.86004056795,45431.570512820515,23645.027624309394
118,Orange County (Northwest) PUMA,4315,2447,1868,39769.36268829664,40647.73191663261,38618.73661670236,450,244,206,42535.555555555555,45307.37704918033,39252.42718446602,3327,1790,1537,41769.88277727683,44162.34636871509,38983.60442420299,538,413,125,25084.386617100372,22661.985472154964,33088.0
119,Nassau County (Central)--Hempstead Town (East Central) PUMA,3691,1788,1903,79541.55513410999,102294.95525727069,58163.16342616921,2040,1054,986,106597.83333333333,133426.07210626185,77919.37119675457,1158,682,476,55035.66493955095,59314.2228739003,48905.46218487395,493,52,441,25146.04462474645,35000.0,23984.126984126986
120,Monroe County (North & West) PUMA,495,335,160,132987.37373737374,167088.80597014926,61587.5,256,256,0,206307.6171875,206307.6171875,0.0,239,79,160,54451.88284518829,40000.0,61587.5,0,0,0,#DIV/0!,0.0,0.0
121,Suffolk County (Northwest)--Smithtown Town PUMA,2930,1602,1328,106892.93515358362,126586.07990012484,83136.59638554217,1654,613,1041,145673.09552599757,221611.5823817292,100956.19596541786,1059,772,287,52023.60717658168,64485.751295336784,18501.742160278747,217,217,0,79078.34101382489,79078.34101382489,0.0
122,Broome County (West Central)--Greater Binghamton City & Greater Johnson City Village PUMA,2189,1427,762,56437.09456372773,57827.54029432376,53833.20209973753,879,540,339,67551.87713310581,65902.5925925926,70179.05604719764,992,707,285,51224.49596774193,56378.35926449788,38439.29824561404,318,180,138,41974.842767295595,39294.444444444445,45471.014492753624
123,"NYC-Brooklyn Community District 12--Borough Park, Kensington & Ocean Parkway PUMA",9718,6179,3539,51548.9287919325,52365.41349732967,50123.36818310257,3911,2308,1603,74088.88775249297,79364.70537261698,66492.76356830943,4487,2847,1640,36516.03521283709,38255.97119775202,33495.54878048781,1320,1024,296,35866.21212121212,30739.6484375,53601.35135135135
124,Suffolk County (Central)--Brookhaven Town (Central) PUMA,7051,4749,2302,56322.6776343781,66674.66835123184,34966.63770634231,1888,1434,454,88229.87288135593,101495.11854951186,46330.396475770925,4876,3028,1848,44152.00984413454,51461.690885072654,32174.891774891774,287,287,0,53198.606271777004,53198.606271777004,0.0
125,NYC-Queens Community District 10--Howard Beach & Ozone Park PUMA,8442,5521,2921,66072.73987206822,76063.43053794603,47189.27422115714,2434,1335,1099,116301.6105176664,161165.39325842698,61803.74886260236,4687,3378,1309,50303.040324301255,52727.29425695678,44047.02062643239,1321,808,513,29475.851627554883,33016.83168316832,23898.635477582848
126,Erie County (South) PUMA,877,608,269,55636.25997719498,55254.93421052631,56498.14126394052,295,162,133,97118.64406779662,115370.37037037036,74887.21804511278,582,446,136,34609.96563573883,33419.28251121076,38514.705882352944,0,0,0,#DIV/0!,0.0,0.0
127,"NYC-Bronx Community District 11--Pelham Parkway, Morris Park & Laconia PUMA",9482,5672,3810,50526.01139000211,47263.61071932299,55382.792650918636,3394,1623,1771,60518.1319976429,60333.641404805916,60687.2049689441,4856,3365,1491,47012.808896210874,43906.74591381872,54022.80348759222,1232,684,548,36846.50974025974,32765.35087719298,41940.51094890511
128,"NYC-Queens Community District 14--Far Rockaway, Breezy Point & Broad Channel PUMA",4106,2803,1303,64876.41987335606,68963.64609347128,56084.02148887183,2215,1389,826,78390.42889390519,80795.39236861051,74346.24697336562,1596,1119,477,52567.5313283208,64548.97229669348,24460.12578616352,295,295,0,30000.0,30000.0,0.0
129,"NYC-Bronx Community District 10--Co-op City, Pelham Bay & Schuylerville PUMA",5976,4209,1767,48347.881526104415,50707.327156094085,42727.6740237691,2190,1467,723,66719.61187214612,73049.0456714383,53876.90179806363,2983,1939,1044,42688.90043580288,46825.265600825165,35006.513409961684,803,803,0,19265.255292652553,19265.255292652553,0.0
130,Nassau County (West Central)--North Hempstead Town (South) PUMA,11978,7504,4474,97904.86809150109,107348.138326226,82066.17791685293,6819,3243,3576,128375.85129784426,167761.00832562443,92658.27181208054,3472,2639,833,66290.0,74159.067828723,41360.26410564226,1687,1622,65,39804.801422643744,40558.38471023428,21000.0
131,Monroe County (Central)--Greece & Gates Towns PUMA,1399,939,460,51964.724803431025,63646.751863684774,28118.152173913044,694,506,188,54125.0,64585.57312252965,25970.478723404256,705,433,272,49838.156028368794,62549.65357967668,29602.573529411766,0,0,0,#DIV/0!,0.0,0.0
132,"NYC-Manhattan Community District 12--Washington Heights, Inwood & Marble Hill PUMA",21792,12146,9646,44144.11481277533,41895.94516713321,46974.953348538256,7627,2445,5182,57935.407106332765,60231.47239263804,56852.06483983018,9602,6737,2865,40232.39950010415,38834.85230814903,43518.70855148342,4563,2964,1599,29323.624808240194,33728.67746288799,21158.16135084428
133,"NYC-Brooklyn Community District 15--Sheepshead Bay, Gerritsen Beach & Homecrest PUMA",23980,13415,10565,67964.89949958299,72736.1065970928,61906.61807856129,11798,6047,5751,81294.77199525344,87620.26790143872,74643.70718135976,10358,6022,4336,57538.15601467465,66068.27632015942,45691.20387453875,1824,1346,478,40955.23574561404,35699.81426448737,55753.97489539749
134,"NYC-Bronx Community District 3 & 6--Belmont, Crotona Park East & East Tremont PUMA",13378,6691,6687,38831.7910001495,37106.292034075625,40558.3221175415,2625,1735,890,52187.80952380953,53257.8674351585,50101.79775280899,8781,3593,5188,39229.90547773602,35059.39326468133,42118.23438704703,1972,1363,609,19280.375253549697,21942.33308877476,13322.660098522167
135,Nassau County (Southwest)--Hempstead Town (Southwest) & Long Beach City PUMA,3814,2014,1800,99080.36182485579,103226.36544190666,94441.44444444444,2067,1171,896,121032.41412675375,121604.61144321093,120284.59821428571,913,437,476,96008.32420591457,116970.25171624713,76763.86554621848,834,406,428,48037.05035971223,35425.862068965514,60000.0
136,NYC-Brooklyn Community District 13--Brighton Beach & Coney Island PUMA,10640,5419,5221,59430.8204887218,53497.892600110725,65588.7473664049,6047,3059,2988,70643.83165205887,59449.68944099379,82103.96586345382,3724,1669,2055,49304.82814178303,53750.736968244455,45694.01459854015,869,691,178,24798.043728423476,26539.073806078148,18039.325842696628
137,NYC-Manhattan Community District 8--Upper East Side PUMA,18448,11021,7427,156940.04661751952,213348.83222938026,73234.4822943315,16945,10249,6696,167384.89111832398,225695.8220314177,78133.28853046594,1412,681,731,40094.90084985836,52690.16152716593,28361.149110807113,91,91,0,25043.956043956045,25043.956043956045,0.0
138,NYC-Brooklyn Community District 7--Sunset Park & Windsor Terrace PUMA,11883,7018,4865,51848.5778002188,52208.98404103733,51328.674203494345,3257,1516,1741,90074.99232422475,110455.3759894459,72328.48937392303,6300,3952,2348,31807.20634920635,34132.79352226721,27892.930153321977,2326,1550,776,52604.04127257094,41328.709677419356,75125.64432989691
139,"NYC-Bronx Community District 7--Bedford Park, Fordham North & Norwood PUMA",15849,10196,5653,32615.795949271247,31381.095527657904,34842.75605872988,3278,1152,2126,43209.762050030506,32754.6875,48874.97648165569,10379,7081,3298,28910.063589941226,29992.889422397966,26585.172832019405,2192,1963,229,34319.61678832117,35582.57768721345,23493.44978165939
140,Monroe County (East) PUMA,2161,1166,995,79666.20083294771,84773.58490566038,73681.06532663316,1078,597,481,89317.866419295,97018.42546063651,79760.2079002079,998,484,514,73641.28256513026,79640.4958677686,67992.21789883268,85,85,0,28000.0,28000.0,0.0
141,Suffolk County (East) PUMA,6787,4040,2747,73666.58317371445,95062.37623762376,42199.890789952675,1517,310,1207,90792.8147659855,270330.6451612903,44681.19304059652,4386,2846,1540,79936.57090743275,101408.6085734364,40255.12987012987,884,884,0,13168.099547511312,13168.099547511312,0.0
142,"NYC-Queens Community District 8--Briarwood, Fresh Meadows & Hillcrest PUMA",21362,12368,8994,61320.59030053366,65563.0417205692,55486.62997553925,12026,6845,5181,72653.6662231831,79728.0219138057,63307.214823393166,8465,4734,3731,48131.39515652687,50174.94507815801,45538.48030018762,871,789,82,33025.48794489093,35002.78833967047,14000.0
143,"NYC-Bronx Community District 9--Castle Hill, Clason Point & Parkchester PUMA",12807,7732,5075,38290.96353556649,37269.408949818935,39847.34975369458,4478,2482,1996,45224.58463599822,44003.622078968576,46742.835671342684,6592,3683,2909,37052.45752427184,38019.603584034754,35827.98212444139,1737,1567,170,25116.2233736327,24839.74473516273,27664.70588235294
144,Suffolk County (Central)--Islip Town (Northwest) PUMA,16340,10963,5377,50713.84516523868,56239.16355012314,39448.44336990887,2234,1330,904,75068.0393912265,72896.01503759398,78263.60619469026,8959,5435,3524,51295.8622614131,64943.11867525299,30247.95119182747,5147,4198,949,39130.095201088014,39693.28251548357,36638.77766069547
145,NYC-Manhattan Community District 7--Upper West Side & West Side PUMA,10540,5089,5451,186128.82352941178,237337.94458636275,138320.49165290772,9349,3898,5451,202216.94298855492,291570.3437660339,138320.49165290772,765,765,0,87720.7843137255,87720.7843137255,0.0,426,426,0,9777.464788732394,9777.464788732394,0.0
146,Capital Region,16855,10594,6261,601989.1418325867,639310.4591365017,534181.6879933681,10804,6921,3883,829225.4553798496,922274.4050004329,646804.2889814251,4907,2769,2138,321288.7227735485,301099.060723165,288344.7757007967,1144,904,240,183035.26805022356,178644.34449771917,48400.0
147,Central NY,7802,3714,4088,500196.3842600135,682470.8601712824,258623.27759461533,3872,2277,1595,747929.5851941796,822586.4408918874,265507.652630852,2947,1043,1904,203858.18756506327,200643.44216155363,160540.34654547687,983,394,589,131829.44707870707,107767.14285714286,112202.64252569192
148,Finger Lakes,15634,10156,5478,647531.9360265869,709753.379059087,442077.7031804335,7909,5544,2365,771690.710304164,789562.2960147228,528863.8159562396,6568,3944,2624,434494.8218046466,451314.2737576055,316689.4760876168,1157,668,489,288564.9705472953,268090.4536390827,80064.8097826087
149,Long Island,162910,100230,62680,1946310.1730614475,2207219.492382175,1593706.0879641934,72021,38273,33748,2596630.258217884,3188086.5238432656,1951432.4951698703,68282,44375,23907,1354718.6632960644,1522754.5902596447,1041658.3940879062,22607,17582,5025,937254.0873449278,1057024.9776644334,500226.24844843894
150,Mid-Hudson,132278,75378,56900,1222312.6976187548,1349725.3951280138,1069437.899456092,51959,24796,27163,1755409.9688726652,2103429.5951289516,1495910.2196741174,60359,35558,24801,939178.5951126108,1048360.7078887626,733982.472936284,19960,15024,4936,609123.5346525762,620707.8707767584,367595.70592048566
151,Mohawk Valley,6151,3835,2316,250149.18152788334,281228.97452305764,175393.3210769687,1587,993,594,230278.5771789119,246087.19928335247,200804.84454478687,3626,2187,1439,277360.3937555303,324439.59636375133,166839.48773448775,938,655,283,66808.0576030576,68174.38056715956,23106.713780918726
152,New York City,751967,440618,311349,3641637.5645105126,3997592.05440567,3182826.9394865697,346082,181964,164118,4564449.627167393,5123685.88628252,3970094.928489355,330870,203679,127191,2579863.4756758865,2816978.537426278,2059851.2684126839,75015,54975,20040,1956054.0652252452,1993653.5712882455,1464400.5734857486
153,North Country,2454,929,1525,175817.48548141855,197358.855883167,156548.3934700804,1623,911,712,197003.6408740388,201736.88023291796,196519.17765943587,758,18,740,144082.1274851404,10000.0,169796.4131994261,73,0,73,17200.0,0.0,17200.0
154,Southern Tier,8636,5261,3375,393230.9465604634,421829.645868952,334791.8518925537,6000,3576,2424,457744.7704211735,513469.4646904994,316444.07683836133,2194,1474,720,216245.89577763216,165972.5470057018,181759.57036761756,442,211,231,147274.8427672956,99294.44444444444,90771.01449275363
155,Western NY,16159,10612,5547,579546.2448181865,608142.2582212928,498338.1817574622,8458,5084,3374,780184.4962888729,811655.2975567838,687716.1798837181,5859,4273,1586,360246.41540821735,375668.6665635128,290900.18893103296,1842,1255,587,159210.69058611203,150040.21799966012,61127.114427860695
