,puma,Total_geo,Total_geo_m,Total_geo_f,Total_Avg_PINCP_mf_t,Total_Avg_PINCP_m,Total_Avg_PINCP_f,Total_BABS,Total_BABS_m,Total_BABS_f,BABS_Avg_PINCP_mf_t,BABS_Avg_PINCP_m,BABS_Avg_PINCP_f,Total_HS,Total_HS_m,Total_HS_f,HS_Avg_PINCP_mf_t,HS_Avg_PINCP_m,HS_Avg_PINCP_f,Total_HSINC,Total_HSINC_m,Total_HSINC_f,HSINC_Avg_PINCP_mf_t,HSINC_Avg_PINCP_m,HSINC_Avg_PINCP_f
0,Total Geo,3592782,2000255,1592527,81806.04076451062,93003.15770939205,67742.17299047363,1839476,935486,903990,107814.94118814271,129885.87689928016,84975.02994502151,1655769,991147,664622,55225.394058591504,61733.38321258098,45520.066931278234,97537,73622,23915,42525.18016752617,45322.78688435522,33912.786201129
1,Nassau County (Central)--Hempstead Town (Northeast) PUMA,29085,16295,12790,82481.18067732509,92311.63485731819,69956.76700547303,11779,6188,5591,98386.66270481366,112272.56787330317,83018.03791808263,17113,9914,7199,71797.67662011336,80500.34698406294,59812.918460897345,193,193,0,59041.45077720207,59041.45077720207,0.0
2,"Chenango, Delaware & Broome (East) Counties PUMA",29834,17048,12786,48334.88630421666,51081.781440638195,44672.35945565462,6893,3421,3472,60490.004352241405,67641.81876644256,53443.24251152074,20718,11696,9022,45579.537020947966,48460.14004787962,41845.16182664598,2223,1931,292,36324.13405308142,37622.863801139305,27735.616438356163
3,Cayuga & Onondaga (South) Counties PUMA,37163,21859,15304,57885.1294567177,65905.79729173338,46429.05403815996,11939,5943,5996,80848.57500628193,101472.94295810196,60406.51050700467,22776,13684,9092,47787.075386371616,54478.173268050276,37716.57567091949,2448,2232,216,39842.933006535946,41264.24731182796,25156.01851851852
4,NYC-Brooklyn Community District 5--East New York & Starrett City PUMA,824,348,476,46733.73786407767,52155.1724137931,42770.16806722689,0,0,0,#DIV/0!,0.0,0.0,824,348,476,46733.73786407767,52155.1724137931,42770.16806722689,0,0,0,#DIV/0!,0.0,0.0
5,"NYC-Staten Island Community District 1--Port Richmond, Stapleton & Mariner's Harbor PUMA",18154,10605,7549,77300.43758951196,80167.18000942952,73273.17525500066,8355,3678,4677,87633.67324955117,96322.60467645459,80800.68419927303,8738,6155,2583,68612.09933623255,72384.13062550772,59623.770809136666,1061,772,289,67483.7700282752,65251.39896373057,73447.05882352941
6,"NYC-Queens Community District 5--Ridgewood, Glendale & Middle Village PUMA",23918,13697,10221,61220.53056275608,66980.90092721034,53501.14959397319,11705,6537,5168,69573.95984621956,73689.81184029371,64367.82120743034,11504,6698,4806,54022.622566063976,62209.450582263366,42612.84852267998,709,462,247,40103.24400564175,41229.87012987013,37995.95141700405
7,"Otsego, Schoharie, Oneida (South) & Herkimer (South) Counties PUMA",32085,17585,14500,48800.13077762194,54484.69525163492,41906.12620689655,9186,3897,5289,55904.544959721316,66666.94893507827,47974.67385138968,21298,12533,8765,47184.166400600996,52741.09119923402,39238.36622932117,1601,1155,446,29534.459712679574,32301.445887445887,22368.83408071749
8,Erie County (Northwest) PUMA,36591,18988,17603,53422.521303052665,57368.6734779861,49165.88678066239,17127,7624,9503,58962.67449057045,66408.93756558237,52988.73892455014,18872,11115,7757,49264.69165960153,51349.00062977958,46278.0867603455,592,249,343,25686.638513513513,49279.076305220886,8559.766763848396
9,NYC-Manhattan Community District 7--Upper West Side & West Side PUMA,49716,26272,23444,181607.67595944967,223199.9668087698,134998.19527384406,45796,23343,22453,191389.34007336886,241996.0385554556,138776.6752772458,3700,2709,991,68600.27027027027,75627.90697674418,49389.50554994954,220,220,0,46000.0,46000.0,0.0
10,"NYC-Manhattan Community District 6--Murray Hill, Gramercy & Stuyvesant Town PUMA",43809,21838,21971,138544.4833253441,149928.26815642457,127229.60948523053,39481,18792,20689,146864.83295762519,165620.82375478928,129828.60215573493,4328,3046,1282,62644.36229205176,53114.57649376231,85286.89547581904,0,0,0,#DIV/0!,0.0,0.0
11,Saratoga County (South & Central) PUMA,37532,20948,16584,82893.75199829479,94936.65505060149,67681.81681138447,21278,10708,10570,97339.03515367986,115351.52876354128,79091.37369914853,15588,9574,6014,65565.48049781883,76832.59661583455,47628.771200532094,666,666,0,26957.357357357356,26957.357357357356,0.0
12,Nassau County (South Central)--Hempstead Town (Southeast) PUMA,23153,13190,9963,102355.87781281043,124052.87695223655,73631.2548429188,13879,7779,6100,121029.63462785503,150658.72567168018,83245.25770491804,9103,5240,3863,74680.36251785126,86645.65267175573,58449.94046078178,171,171,0,60000.0,60000.0,0.0
13,Columbia & Greene Counties PUMA,28363,15158,13205,54660.10901526637,58343.19521044993,50432.299810677774,8426,3744,4682,74097.80192262046,77040.0267094017,71745.02755232806,18916,10748,8168,47194.88438359061,53015.661797543726,39535.516650342804,1021,666,355,32554.515181194907,39213.15315315315,20062.535211267605
14,NYC-Staten Island Community District 2--New Springville & South Beach PUMA,23398,12352,11046,80160.53380630823,92396.55845207254,66477.80916168749,9888,4242,5646,116482.45550161813,150335.93116454504,91047.37867516826,13058,7658,5400,52804.123908714966,61276.556542178114,40788.95925925926,452,452,0,75888.05309734514,75888.05309734514,0.0
15,Nassau County (Northeast)--Oyster Bay Town (North) & Glen Cove City PUMA,25201,16029,9172,149965.56204118885,181238.86162580323,95312.30004361099,18618,11447,7171,175294.39837791384,217193.48239713462,108411.28378189931,6361,4463,1898,79210.26882565634,91821.40264396147,49556.16438356164,222,119,103,53128.37837837838,76176.4705882353,26500.0
16,NYC-Brooklyn Community District 18--Canarsie & Flatlands PUMA,10218,6047,4171,81186.27715795655,88534.06317182074,70533.66099256773,4517,2058,2459,83868.40823555457,78580.22351797862,88294.2252948353,5420,3708,1712,81657.33948339484,98571.29989212514,45023.59813084112,281,281,0,28985.76512455516,28985.76512455516,0.0
17,Putnam County PUMA,26238,15377,10861,84958.49759890235,93060.6542238408,73487.46708406224,14781,7553,7228,100054.28726067248,115661.33721699986,83745.48146098506,11338,7705,3633,65536.74722173222,71410.8500973394,53078.733828791635,119,119,0,60361.34453781512,60361.34453781512,0.0
18,Nassau County (Northwest)--North Hempstead Town (North) PUMA,19430,12178,7252,156437.48728769942,198504.18935785844,85796.5195808053,14893,9087,5806,184030.15362922178,243707.353141851,90629.06648294868,4379,3021,1358,66998.01324503311,65860.74147633235,69527.9823269514,158,70,88,34398.73417721519,55000.0,18011.363636363636
19,NYC-Queens Community District 3--Jackson Heights & North Corona PUMA,5275,3023,2252,73671.83696682465,81406.05358914984,63289.71580817051,4197,2587,1610,81240.39552060996,89082.14147661383,68640.0248447205,1078,436,642,44205.00927643785,35860.091743119265,49872.27414330218,0,0,0,#DIV/0!,0.0,0.0
20,Rockland County (North)--New City & Congers PUMA,17112,9107,8005,100057.81556802244,121908.4857801691,75199.09556527171,10329,5094,5235,120059.05024687773,154913.91244601493,86142.9723018147,6503,3800,2703,70083.71674611718,81694.50263157894,53760.747317795045,280,213,67,58375.0,50000.0,85000.0
21,"NYC-Bronx Community District 3 & 6--Belmont, Crotona Park East & East Tremont PUMA",502,182,320,50912.47011952191,78600.0,35165.1875,502,182,320,50912.47011952191,78600.0,35165.1875,0,0,0,#DIV/0!,0.0,0.0,0,0,0,#DIV/0!,0.0,0.0
22,Orange County (Northwest) PUMA,21695,12243,9452,75414.22258584927,86050.99901984808,61636.603681760476,7190,2935,4255,110172.35340751043,153919.31209540035,79996.71915393654,13945,8844,5101,58154.66747938329,64640.23066485753,46910.14271711429,560,464,96,58938.392857142855,64851.293103448275,30359.375
23,NYC-Brooklyn Community District 2--Brooklyn Heights & Fort Greene PUMA,35401,18589,16812,118550.62854156662,134940.49115068052,100428.38514156555,32006,16167,15839,123130.92888833344,141900.64885260098,103972.51846707494,2859,2269,590,84609.47569080097,93476.33318642573,50509.645762711865,536,153,383,26089.17910447761,14400.0,30758.74673629243
24,Dutchess County (Southwest) PUMA,37764,21962,15802,82149.67680860078,90933.92737455605,69941.11390963169,15680,8288,7392,113896.88329081633,122346.47804054055,104423.09523809524,20785,13126,7659,61595.014914601874,73785.78569251866,40702.462723593155,1299,548,751,27825.15781370285,26589.56204379562,28726.76431424767
25,Westchester County (Northwest) PUMA,28575,16472,12103,119102.0704111986,134742.49939290917,97815.68305378832,18987,10816,8171,142772.1373571391,166226.8953402367,111724.93844082732,9266,5334,3932,72754.70429527304,75587.99212598425,68911.17497456765,322,322,0,57086.95652173913,57086.95652173913,0.0
26,Nassau County (Southeast)--Oyster Bay Town (South) PUMA,31918,18104,13814,84879.12557177768,95756.30855059656,70623.98436368901,18013,9564,8449,100069.86509742963,114542.74989544124,83687.01858208072,13605,8240,5365,65390.2572583609,75376.98422330097,50051.83597390494,300,300,0,56596.666666666664,56596.666666666664,0.0
27,Westchester County (South Central)--New Rochelle & Mount Vernon Cities PUMA,24494,12997,11497,113333.38940148609,144126.8361929676,78522.35800643647,16629,9114,7515,135047.33116844067,167848.4068466096,95267.0246174318,7694,3786,3908,67221.98726280218,88921.31801373481,46200.066530194475,171,97,74,76491.22807017544,70000.0,85000.0
28,Saratoga County (Outer) PUMA,41378,23597,17781,63045.06573541495,74648.38030258083,47646.41471233339,15158,7311,7847,81692.30901174297,105425.1798659554,59580.544157002674,23834,14653,9181,53769.99622388185,62951.13765099297,39116.77050430237,2386,1633,753,37230.771165129925,41819.54684629516,27279.282868525897
29,NYC-Queens Community District 9--Richmond Hill & Woodhaven PUMA,6140,3705,2435,69678.70684039088,67860.88529014845,72444.63244353182,3113,1466,1647,80176.0681015098,91511.10504774898,70086.71523983,2873,2085,788,58401.726418378,51231.79856115108,77372.9187817259,154,154,0,67863.63636363637,67863.63636363637,0.0
30,Erie County (South) PUMA,58402,32842,25560,64346.5670182528,75118.7204189757,50505.44565727699,23352,10816,12536,82384.99451867078,104943.55325443787,62921.5794511806,34461,21437,13024,52720.07240068483,61326.31170406307,38554.5355497543,589,589,0,29418.336162988115,29418.336162988115,0.0
31,"NYC-Queens Community District 12--Jamaica, Hollis & St. Albans PUMA",825,570,255,53887.51515151515,50223.15789473684,62078.43137254902,257,124,133,72770.4280155642,58580.645161290326,86000.0,517,395,122,46659.96131528047,49952.40506329114,36000.0,51,51,0,32000.0,32000.0,0.0
32,NYC-Brooklyn Community District 1--Greenpoint & Williamsburg PUMA,39486,22738,16748,87407.63835283392,96501.06508927786,75061.90530212563,28741,15028,13713,101156.32511046936,117468.14945435188,83280.28804783782,8360,5889,2471,53421.41961722488,58999.637969094925,40127.154997976526,2385,1821,564,40855.765199161426,44745.19494783086,28297.872340425532
33,Suffolk County (Central)--Brookhaven Town (Central) PUMA,32272,17286,14986,79789.05583787804,88739.4024065718,69465.04070465769,12478,6482,5996,98483.06058663248,114125.89170009256,81572.3148765844,19536,10672,8864,68137.069000819,73299.68890554723,61921.42373646209,258,132,126,57965.11627906977,90386.36363636363,24000.0
34,St. Lawrence County PUMA,28104,16100,12004,56335.70961428978,64099.6701242236,45922.533655448184,9050,4040,5010,70023.4155801105,91556.27202970297,52659.59520958084,17622,10997,6625,50293.69038701623,55663.26179867236,41380.607094339626,1432,1063,369,44183.98044692737,47025.83254938852,35997.28997289973
35,Genesee & Orleans Counties PUMA,32095,17984,14111,50523.620065430754,58786.60286921708,39992.723407270925,8182,3657,4525,68125.30628208262,91486.54252119224,49245.29723756906,22482,13135,9347,45438.5432790677,52272.248191853825,35835.385685246605,1431,1192,239,29772.88609364081,30248.322147651008,27401.673640167362
36,Monroe County (Central)--Rochester City (West) PUMA,10986,5800,5186,52661.94948115784,60042.472413793104,44407.60451214809,5069,2344,2725,48870.1690668771,47917.06484641638,49690.01357798165,5641,3370,2271,57906.273710335045,69689.53709198812,40420.761778952,276,86,190,15115.942028985508,12500.0,16300.0
37,Wayne & Seneca Counties PUMA,38927,21544,17383,51612.88447607059,60130.72317118455,41056.11540010355,9678,3893,5785,68809.29861541641,95263.65014127921,51006.91477960242,26504,15222,11282,45280.77241171144,52191.82367625805,35956.18259173905,2745,2429,316,52122.684881602916,53573.886372993,40967.72151898734
38,Warren & Washington Counties PUMA,39002,21585,17417,52346.008999538484,57365.92883947185,46124.79009014182,11073,4154,6919,71723.73701797164,91661.16995666827,59753.785229079345,26639,16344,10295,45078.74180712489,49760.668991678904,37645.869742593495,1290,1087,203,36084.88372093023,40657.497700092,11600.0
39,Erie County (North Central) PUMA,30337,17559,12778,73709.49016053004,87320.67230480096,55005.565659727654,17277,9724,7553,84618.93401632228,102708.0013368984,61330.42737984907,12458,7386,5072,59933.81602183336,70096.54481451394,45134.54258675079,602,449,153,45694.352159468435,37412.026726057906,70000.0
40,"Clinton, Franklin, Essex & Hamilton Counties PUMA",48070,26900,21170,53137.419575618886,60766.9936802974,43442.778885214924,12430,5720,6710,72913.02220434434,88741.64685314686,59419.768405365125,32228,18393,13835,47834.26191510488,56278.94361985538,36607.44365739068,3412,2787,625,31185.31652989449,32971.40294223179,23220.8
41,Dutchess County (North & East) PUMA,34614,19527,15087,71708.80684116253,78817.18400163876,62508.48333001922,12752,6285,6467,101590.00235257215,118151.58790771679,85494.50749961342,19892,11552,8340,55390.444902473355,62364.112015235456,45730.99616306955,1970,1690,280,43058.9847715736,45000.11834319527,31342.85714285714
42,Tompkins County PUMA,24121,13984,10137,60454.25770075867,62402.58581235698,57766.53743711157,12453,6484,5969,75288.50317192644,82567.4059222702,67381.5831797621,11321,7153,4168,45345.71327621235,46131.70697609395,43996.813819577736,347,347,0,21010.374639769452,21010.374639769452,0.0
43,"NYC-Manhattan Community District 4 & 5--Chelsea, Clinton & Midtown Business District PUMA",40404,22998,17406,157963.51994851994,184011.61231411426,123546.9952889808,37313,20758,16555,163115.83791171978,192561.90673475288,126193.97160978556,3091,2240,851,95767.32449045616,104776.33928571429,72053.81903642773,0,0,0,#DIV/0!,0.0,0.0
44,Onondaga County (Central)--Syracuse City PUMA,22297,11967,10330,61926.1964838319,59736.720982702434,64462.63920619555,11081,5270,5811,75458.38200523419,64621.08159392789,85286.73739459645,10387,5868,4519,49641.289303937614,58849.05248807089,37684.84886036734,829,829,0,34969.84318455971,34969.84318455971,0.0
45,Suffolk County (South Central)--Brookhaven Town (South) PUMA,29335,16571,12764,65122.69405147435,67586.44197694768,61924.10686305234,9278,3970,5308,77741.77840051736,69587.58942065491,83840.52185380558,19728,12334,7394,59097.62824412003,66644.41381546944,46508.765215039224,329,267,62,70541.03343465045,81348.31460674158,24000.0
46,Suffolk County (Northwest)--Smithtown Town PUMA,32426,18969,13457,109096.55276629864,117611.43813590595,97093.96225013005,19957,11334,8623,118948.62103522573,134566.33580377625,98420.82569871274,12372,7538,4834,93989.18444875526,93515.98832581587,94727.0728175424,97,97,0,9000.0,9000.0,0.0
47,Herkimer (North & Central) & Oneida (Outer) Counties PUMA,37706,21635,16071,52307.42982549196,54336.800415992606,49575.463381245725,9928,4223,5705,75925.75735294117,82826.51361591286,70817.62524101665,25897,15725,10172,44069.99575240375,48136.97678855326,37782.80770743217,1881,1687,194,41059.19723551303,40809.92886781268,43226.80412371134
48,NYC-Queens Community District 2--Sunnyside & Woodside PUMA,13730,8030,5700,82122.81063364894,76017.93399750935,90723.18947368421,10079,5557,4522,90976.51453517214,84272.16303761023,99215.36488279523,3256,2365,891,55763.08353808354,56466.638477801265,53895.622895622895,395,108,287,73491.89873417722,79444.44444444444,71251.91637630662
49,Onondaga County (Central)--Syracuse City (Outer) PUMA,51251,27372,23879,64409.732532048154,76986.70575770861,49993.01026006114,24822,12907,11915,86062.06067198452,108138.41698303247,62147.70642047839,24888,13192,11696,45239.77949212472,51369.23605215282,38326.3226744186,1541,1273,268,25245.360155743023,26610.054988216812,18763.059701492537
50,Broome County (West Central)--Greater Binghamton City & Greater Johnson City Village PUMA,27942,15677,12265,52997.65156395391,58451.35612680997,46026.781084386464,11684,6153,5531,71369.56093803492,86880.60620835365,54114.189115892244,14720,8498,6222,40126.73097826087,41475.02824193928,38285.22822243652,1538,1026,512,36614.40182054616,28567.98245614035,52738.671875
51,Erie County (West Central)--Buffalo City (West) PUMA,22419,11471,10948,62809.89607029752,73912.54554964694,51176.858786993056,12302,6126,6176,74915.40643797757,88414.92817499184,61525.17487046632,9081,4356,4725,48495.20207025658,59902.561983471074,37978.70264550264,1036,989,47,44537.45173745174,45789.07987866532,18200.0
52,"Steuben (North & West), Schuyler & Chemung (North) Counties PUMA",28819,16963,11856,47835.35820118672,51491.871013382064,42603.79385964912,6749,3597,3152,68655.32375166692,75334.53711426188,61033.13769035533,19670,11299,8371,42506.82033553635,46752.50252234711,36776.087683669815,2400,2067,333,32959.68833333333,35907.959361393325,14659.159159159159
53,Monroe County (North & West) PUMA,36613,20689,15924,64972.73277251249,75413.73599497318,51407.42784476262,16081,7841,8240,80062.29674771469,100695.25494197168,60428.43446601942,19896,12694,7202,53871.09826095698,59758.41263589097,43494.31838378228,636,154,482,30731.918238993712,78636.36363636363,15426.348547717842
54,NYC-Brooklyn Community District 8--Crown Heights North & Prospect Heights PUMA,17377,8935,8442,102958.18035334062,88013.34079462787,118775.77588249231,15529,8058,7471,108430.76824006697,92296.05361131794,125833.19502074689,1463,735,728,57102.93916609706,50345.034013605444,63925.82417582418,385,142,243,56470.90909090909,39957.74647887324,66120.57613168724
55,Cattaraugus & Allegany Counties PUMA,35461,20809,14652,45899.0494909901,50768.326493344226,38983.62598962599,8625,4325,4300,61649.08707246377,67793.58520231214,55468.86511627907,25110,15127,9983,41750.93341298288,47747.57519666821,32664.366222578385,1726,1357,369,27541.64542294322,30179.27781871776,17841.734417344174
56,"NYC-Queens Community District 11--Bayside, Douglaston & Little Neck PUMA",13006,6470,6536,89603.41211748424,99366.12519319938,79939.28212974296,8155,3461,4694,100110.63372164316,112333.53655013003,91098.3911376225,4851,3009,1842,71939.75675118533,84450.8009305417,51502.33441910966,0,0,0,#DIV/0!,0.0,0.0
57,Chemung (South) & Steuben (East) Counties--Greater Elmira & Greater Corning Cities PUMA,30942,17067,13875,51653.5582703122,58352.43921017167,43413.57261261261,10903,5168,5735,67597.27506190956,86536.22291021672,50530.75675675676,19489,11525,7964,43522.19764995638,46818.1240780911,38752.54018081366,550,374,176,23722.18181818182,24339.57219251337,22410.227272727272
58,Suffolk County (Southwest)--Babylon Town (Southeast) PUMA,24469,14175,10294,79781.5048428624,88272.1666313933,68089.72993977074,11191,5748,5443,94928.170136717,106923.4711203897,82260.70916773837,12982,8365,4617,67493.76752426436,75420.90257023311,53131.522633744855,296,62,234,46041.89189189189,93000.0,33600.0
59,Jefferson & Lewis Counties PUMA,38071,22536,15535,49967.89361981561,53217.23526801562,45254.20431284197,8736,3552,5184,72013.80173992674,76376.41047297297,69024.60686728395,28476,18330,10146,43282.29056047198,48629.89110747408,33621.190814113936,859,654,205,47390.6868451688,56007.186544342505,19901.951219512193
60,NYC-Brooklyn Community District 3--Bedford-Stuyvesant PUMA,13378,8107,5271,71438.84362386007,77366.1329715061,62322.44545627016,9717,5039,4678,77153.81393434187,88291.92300059536,65156.17999144934,2982,2574,408,64216.14352783367,67990.10878010879,40406.86274509804,679,494,185,21373.63770250368,14772.672064777327,39000.0
61,Schenectady County--Schenectady City PUMA,39608,21090,18518,57056.88537669158,60079.88553816975,53614.01501242035,16983,7973,9010,72502.93210857917,79739.63953342532,66099.12874583795,21349,11954,9395,45467.385826034006,48475.626568512635,41639.763704097924,1276,1163,113,45382.91536050157,44576.956147893376,53677.87610619469
62,NYC-Queens Community District 1--Astoria & Long Island City PUMA,31800,19123,12677,77609.24911949686,84427.01218428071,67324.79040782519,25587,14650,10937,81137.75440653457,91529.88764505119,67217.59787876018,6089,4473,1616,63237.707341106914,61163.62620165437,68978.650990099,124,0,124,55225.8064516129,0.0,55225.8064516129
63,Suffolk County (North Central)--Brookhaven Town (North) PUMA,28038,15561,12477,102820.94115129467,120997.90309106099,80151.09224973952,15410,8338,7072,129020.20687865022,157948.6699448309,94913.09078054299,11915,6715,5200,73567.10029374738,82472.1072226359,62067.653846153844,713,508,205,25442.01963534362,23764.094488188977,29600.0
64,Fulton & Montgomery Counties PUMA,31697,17368,14329,51901.116509448846,54381.45842929526,48894.72538209226,8137,3340,4797,72961.52513211257,79082.21856287424,68699.8790910986,21623,12580,9043,46250.67566942608,50815.91891891892,39899.823067566074,1937,1448,489,26506.65978316985,28382.803867403316,20951.124744376277
65,NYC-Brooklyn Community District 16--Brownsville & Ocean Hill PUMA,1274,532,742,75062.79434850863,86093.98496240602,67153.63881401617,1134,392,742,72173.721340388,81676.02040816327,67153.63881401617,140,140,0,98464.28571428571,98464.28571428571,0.0,0,0,0,#DIV/0!,0.0,0.0
66,"Rockland County (South)--Orangetown, Clarkstown (South) & Ramapo (Southeast) Towns PUMA",22698,13784,8914,106969.35505330867,125795.64139582124,77857.67332286292,15985,10126,5859,122129.31998748827,142904.96543551254,86223.1609489674,6559,3504,3055,70940.88138435737,78898.24229452055,61814.009819967265,154,154,0,67870.12987012987,67870.12987012987,0.0
67,Oswego County PUMA,35779,21274,14505,53276.97151960647,60537.2878631193,42628.507549120994,7835,3612,4223,66434.91895341416,81051.85215946844,53932.82026995027,26012,16220,9792,51323.64962325081,59060.01060419236,38508.72160947712,1932,1442,490,26215.52795031056,25768.099861303745,27532.244897959183
68,"NYC-Manhattan Community District 12--Washington Heights, Inwood & Marble Hill PUMA",18552,8875,9677,72148.4452350151,77873.05645070423,66898.27219179498,15391,7116,8275,74873.07166525892,80520.59808881395,70016.54018126888,2984,1582,1402,60002.18163538874,70201.51706700379,48493.37375178317,177,177,0,40000.0,40000.0,0.0
69,Monroe County (Central)--Rochester City (East) PUMA,15966,8092,7874,53904.104096204435,64057.56673257538,43469.53213106426,8658,4451,4207,68595.01963501963,82136.55807683666,54268.09127644402,6413,3146,3267,37569.606424450336,41854.11633820725,33443.78206305479,895,495,400,28830.569832402234,42608.0,11781.0
70,Westchester County (Northeast) PUMA,32652,18892,13760,150388.63650006126,197870.37587338555,85197.86468023255,23554,13443,10111,175147.97783815913,235965.04946812466,94289.12174859064,8687,5112,3575,83826.57868078738,100342.52366979656,60209.93230769231,411,337,74,138327.9805352798,157679.52522255192,50200.0
71,"NYC-Bronx Community District 1 & 2--Hunts Point, Longwood & Melrose PUMA",451,142,309,52367.538802660754,49977.18309859155,53466.01941747573,249,105,144,71055.2610441767,51731.04761904762,85145.83333333333,130,37,93,26192.30769230769,45000.0,18709.677419354837,72,0,72,35000.0,0.0,35000.0
72,"NYC-Queens Community District 7--Flushing, Murray Hill & Whitestone PUMA",14944,8945,5999,78393.27690042826,86263.56176634991,66658.03800633439,7474,4001,3473,87647.85790741237,100607.12821794552,72718.39044054132,6874,4348,2526,69497.38725632819,75987.6816927323,58325.65320665083,596,596,0,64939.597315436244,64939.597315436244,0.0
73,Onondaga County (North) PUMA,43631,23302,20329,63307.47810043318,69777.94528366663,55890.74209257711,17567,8475,9092,83991.84715660044,97239.43351032448,71643.26660800703,24845,13900,10945,50073.334594485816,55064.638992805754,43734.44641388762,1219,927,292,34956.35767022149,39334.4120819849,21057.534246575342
74,Suffolk County (Central)--Brookhaven Town (West Central) PUMA,28058,16213,11845,73220.56490127592,83544.53216554617,59089.498522583366,9353,4849,4504,93166.9485726505,113496.78284182305,71279.87788632327,17645,10957,6688,62482.73165202607,69250.76206990964,51394.617224880385,1060,407,653,75966.35849056604,111501.2285012285,53818.284839203676
75,Monroe County (South) PUMA,45457,26149,19308,80197.6074091999,93332.20463497649,62409.30293142739,31126,16816,14310,94677.78773372743,114852.16282112274,70970.42983927323,13836,8903,4933,49054.87995085285,55127.46815680108,38095.1692681938,495,430,65,40158.58585858586,42767.441860465115,22900.0
76,"NYC-Brooklyn Community District 15--Sheepshead Bay, Gerritsen Beach & Homecrest PUMA",12455,7488,4967,79064.88823765556,93285.18336004273,57627.08475941212,5722,2659,3063,92322.35284865432,122118.6434749906,66456.09859614757,6618,4714,1904,67238.543366576,76857.4416631311,43423.68697478992,115,115,0,100000.0,100000.0,0.0
77,Rensselaer County--Troy City PUMA,52565,28786,23779,62244.97736136212,65882.84315292156,57841.108204718446,23809,12136,11673,78643.60052921165,84632.64032630192,72417.01036580143,27583,15549,12034,48785.00344415038,52714.69547880893,43707.49127472162,1173,1101,72,45903.66581415175,45178.019981834695,57000.0
78,Suffolk County (Central)--Islip Town (East) PUMA,29826,16844,12982,84409.78575739288,97975.6477083828,66808.23139731937,14605,7555,7050,95387.65559739814,109105.89146260754,80686.76595744681,15083,9151,5932,73758.9047271763,88956.70418533494,50314.01888064734,138,138,0,86695.65217391304,86695.65217391304,0.0
79,Nassau County (West Central)--Hempstead Town (Northwest) PUMA,19508,11110,8398,108495.16629075252,127622.0098109811,83191.6140747797,12270,6421,5849,124803.26601466992,161573.46192181902,84437.14737561977,7079,4530,2549,81963.11343410086,82880.03973509934,80333.58179678305,159,159,0,31262.578616352203,31262.578616352203,0.0
80,Ontario & Yates Counties PUMA,40293,22994,17299,62726.86168813441,72223.6671305558,50103.615006647786,15187,7866,7321,83693.66128926055,104425.28604118993,61418.70427537222,22554,12900,9654,46893.34016139044,54828.076899224805,36290.67764657137,2552,2228,324,77886.13244514106,59254.71723518851,206005.86419753087
81,Suffolk County (West Central)--Babylon Town (Northwest) PUMA,14841,9283,5558,86060.50535678188,84986.7456641172,87853.90428211587,5481,2669,2812,105143.84783798577,96112.0756837767,113716.32290184921,9024,6474,2550,75888.36768617021,80974.87333951189,62974.62745098039,336,140,196,47958.03571428572,58410.71428571428,40491.836734693876
82,Nassau County (Southwest)--Hempstead Town (Southwest) & Long Beach City PUMA,25241,14899,10342,99579.67699377995,108214.49426135983,87140.09640301683,16369,10386,5983,115981.70749587636,122653.42769112266,104400.14541200067,8760,4513,4247,69564.61837899544,74985.43097717705,63804.287026136095,112,0,112,50000.0,0.0,50000.0
83,"NYC-Bronx Community District 8--Riverdale, Fieldston & Kingsbridge PUMA",7638,4047,3591,114018.20240900759,136573.5433654559,88598.69117237539,6583,3355,3228,123456.90870423819,153104.956780924,92642.41016109046,1055,692,363,55122.4644549763,56424.85549132948,52639.669421487604,0,0,0,#DIV/0!,0.0,0.0
84,"Rockland County (West)--Spring Valley, Suffern Villages & Monsey PUMA",9293,5730,3563,98642.47325944259,107412.58359511344,84538.42267751895,4377,2040,2337,135779.3474982865,185211.66862745097,92629.18271287976,4118,3012,1106,70516.63428848956,69153.8844621514,74227.84810126582,798,678,120,40088.721804511275,43290.265486725664,22000.0
85,Chautauqua County PUMA,33013,18819,14194,46224.10008178596,48672.24411499017,42978.24813301395,8932,4376,4556,62047.27787729512,66499.77148080438,57770.69490781387,22520,13290,9230,40916.29795737123,43931.00541760722,36575.511159263275,1561,1153,408,32258.103779628444,35660.797918473545,22642.156862745098
86,Orange County (Southeast) PUMA,24662,14545,10117,74532.2013218717,81674.0756961155,64264.47741425324,10204,5786,4418,91260.19600156801,100338.88696854476,79370.35762788593,13162,7463,5699,65541.73826166237,75459.58475144044,52554.0407088963,1296,1296,0,34130.97993827161,34130.97993827161,0.0
87,Monroe County (East) PUMA,39701,21124,18577,68047.14241454875,75720.22964400682,59322.036389083274,23186,12423,10763,82359.50470111275,89731.31256540288,73850.72749233485,15970,8308,7662,48172.64402003757,57028.65129995185,38569.96737144349,545,393,152,41532.11009174312,27959.287531806614,76625.0
88,Broome (Outer West) & Tioga Counties PUMA,35750,20282,15468,56989.14830769231,63404.52332117148,48577.15994310835,11388,5513,5875,87195.09922725677,110633.35751859241,65201.03659574468,22718,13508,9210,43762.970419931335,46966.05285756589,39065.11617806732,1644,1261,383,30521.350364963502,33014.59159397304,22312.532637075718
89,Suffolk County (East) PUMA,32769,17253,15516,85811.52998260551,97782.01819973339,72500.95810775972,15728,7854,7874,106614.90717192269,127368.56378915203,85913.9649479299,15371,8475,6896,64845.06317090625,69906.36696165192,58624.855858468676,1670,924,746,82865.4491017964,101974.02597402598,59197.45308310992
90,"NYC-Queens Community District 14--Far Rockaway, Breezy Point & Broad Channel PUMA",10373,6059,4314,83833.54574375783,86836.86086813005,79615.39870190079,6106,3256,2850,84474.49721585326,90375.07678132679,77733.34385964912,4027,2770,1257,85621.72585050906,82404.29241877256,92711.85361972952,240,33,207,37522.5,109800.0,26000.0
91,NYC-Brooklyn Community District 14--Flatbush & Midwood PUMA,12301,6472,5829,81902.70969839851,99938.15080346106,61877.769771830506,8222,3807,4415,91923.13184140112,118462.21696874179,69038.80634201586,3618,2449,1169,66906.9767827529,78029.42098815844,43605.97946963216,461,216,245,20875.92190889371,21851.85185185185,20015.51020408163
92,Albany County (Outside Albany City) PUMA,61738,32811,28927,73034.41972529075,82273.05467678522,62555.322294050544,29964,13771,16193,89248.59511413696,107790.83900951274,73479.72951275243,29832,18115,11717,59347.88485518906,65099.77107369583,50455.21447469489,1942,925,1017,33104.01647785788,38693.18918918919,28020.452310717796
93,"NYC-Bronx Community District 5--Morris Heights, Fordham South & Mount Hope PUMA",190,190,0,51789.47368421053,51789.47368421053,0.0,0,0,0,#DIV/0!,0.0,0.0,190,190,0,51789.47368421053,51789.47368421053,0.0,0,0,0,#DIV/0!,0.0,0.0
94,"NYC-Manhattan Community District 9--Hamilton Heights, Manhattanville & West Harlem PUMA",10591,5916,4675,110451.20762911906,111585.72346179851,109015.5294117647,8998,5250,3748,123774.7655034452,119983.37904761905,129085.53895410885,1593,666,927,35193.59698681733,45387.98798798799,27869.471413160732,0,0,0,#DIV/0!,0.0,0.0
95,Nassau County (West Central)--Hempstead Town (West Central) PUMA,15123,9043,6080,82001.65086292403,87835.46566404954,73324.81085526316,7735,3776,3959,96270.89411764705,113465.33792372882,79871.24273806516,7352,5231,2121,67008.65070729054,69402.21754922577,61105.421970768504,36,36,0,78000.0,78000.0,0.0
96,Erie County (West Central)--Buffalo City (East) PUMA,17248,9843,7405,50321.31087662338,45034.44579904501,57348.8075624578,6618,3341,3277,67016.66666666667,54829.51212211913,79441.83704607873,9902,6060,3842,40332.12987275298,40248.73432343234,40463.66996356064,728,442,286,34418.846153846156,36609.32126696833,31033.566433566433
97,NYC-Queens Community District 6--Forest Hills & Rego Park PUMA,11100,5615,5485,99509.48387387388,107120.2911843277,91718.29279854147,9709,4824,4885,105007.87372540942,112683.83291873963,97427.76581371545,1391,791,600,61131.43421998562,73190.42351453856,45233.666666666664,0,0,0,#DIV/0!,0.0,0.0
98,"NYC-Queens Community District 13--Queens Village, Cambria Heights & Rosedale PUMA",6547,3220,3327,63640.73316022606,74135.27329192546,53483.70904718966,2570,1462,1108,76493.36186770428,82444.21340629275,68641.24548736462,3867,1648,2219,55771.38350142229,69042.56067961165,45915.18702118071,110,110,0,40000.0,40000.0,0.0
99,"NYC-Bronx Community District 11--Pelham Parkway, Morris Park & Laconia PUMA",5556,3651,1905,58113.8588912887,62909.91509175568,48922.04724409449,2253,1522,731,81271.81535730137,90919.05387647831,61185.49931600547,3059,1975,1084,44420.372670807454,45208.61772151899,42984.22509225092,244,154,90,15956.065573770491,13105.714285714286,20833.333333333332
100,Madison & Cortland Counties PUMA,38690,21605,17085,52271.340553114496,57173.6108308262,46072.12783143108,12921,6178,6743,66416.3377447566,77697.70929103269,56080.23906273172,23885,14191,9694,46087.57462842789,49709.92248608273,40784.83701258511,1884,1236,648,33657.61464968153,40279.857605178,21026.29938271605
101,Nassau County (Central)--Hempstead Town (East Central) PUMA,33976,17972,16004,99077.20473275254,117403.1297574004,78497.75431142215,21811,10658,11153,110147.6727339416,132510.71777068867,88777.15950865237,12015,7247,4768,79325.8608406159,95364.12556920105,54948.909395973154,150,67,83,71440.0,98000.0,50000.0
102,Nassau County (West Central)--North Hempstead Town (South) PUMA,18272,8781,9491,96300.9040061296,118065.66655278442,76164.31356021494,11832,5266,6566,108815.11054766734,143851.44094189137,80715.6107219007,6347,3422,2925,73604.93146368364,80150.11689070718,65947.62393162394,93,93,0,53110.0,53110.0,0.0
103,Westchester County (Central)--White Plains City PUMA,31116,17845,13271,134496.38520375369,157335.78537405437,103785.12787280536,24400,13684,10716,151497.36155737704,181479.58126278865,113210.9958939903,6586,4031,2555,72191.60340115396,77224.13793103448,64251.81996086106,130,130,0,100000.0,100000.0,0.0
104,"NYC-Staten Island Community District 3--Tottenville, Great Kills & Annadale PUMA",38715,23003,15712,77486.20973782771,83200.63730817719,69120.05791751528,17883,9369,8514,83663.32550466924,93223.823246878,73142.73549447968,20325,13127,7198,71965.03616236162,76134.09461415403,64361.919977771606,507,507,0,80942.80078895463,80942.80078895463,0.0
105,Suffolk County (Northwest)--Huntington Town (South) PUMA,26176,15880,10296,104634.94880806845,113915.26889168765,90321.47921522922,16918,9832,7086,123306.50195058518,136721.6995524817,104692.58396838837,9258,6048,3210,70514.6921581335,76839.73544973545,58597.60124610592,0,0,0,#DIV/0!,0.0,0.0
106,NYC-Manhattan Community District 3--Chinatown & Lower East Side PUMA,21841,11761,10080,103448.33157822445,125087.23662953831,78200.79563492064,19378,10819,8559,110738.32077613789,132901.86616138276,82722.50146045099,2230,942,1288,45685.125560538116,35335.138004246284,53254.759316770185,233,0,233,50000.0,0.0,50000.0
107,NYC-Brooklyn Community District 13--Brighton Beach & Coney Island PUMA,4633,3202,1431,61739.12065616231,64023.891317926296,56626.72676450035,1989,1247,742,61613.34640522876,64946.190858059344,56012.191374663074,2469,1780,689,60117.294451194815,61212.247191011236,57288.53410740203,175,175,0,86050.28571428571,86050.28571428571,0.0
108,NYC-Brooklyn Community District 7--Sunset Park & Windsor Terrace PUMA,13281,6426,6855,84044.06528122882,91297.5879240585,77244.48300510577,11690,5179,6511,87214.00607356716,98003.0700907511,78632.1350023038,1516,1172,344,57079.48548812665,58869.795221843,50979.941860465115,75,75,0,135000.0,135000.0,0.0
109,Suffolk County (Northwest)--Huntington Town (North) PUMA,26117,15390,10727,123427.06574261974,141244.55074723848,97864.36468723782,18366,9734,8632,141819.98562561255,172281.1337579618,107470.03012048193,7751,5656,2095,79845.02902851245,87830.45968882603,58286.27207637231,0,0,0,#DIV/0!,0.0,0.0
110,Suffolk County (Southwest)--Islip Town (South) PUMA,26396,13787,12609,81425.58039096833,87820.24008123594,74433.49750178444,12962,5789,7173,99100.45054775498,109441.79478320954,90754.42492680886,13058,7842,5216,64873.21029254097,72705.82759500128,53097.254601226996,376,156,220,46955.31914893617,45256.41025641026,48160.0
111,"NYC-Brooklyn Community District 17--East Flatbush, Farragut & Rugby PUMA",1260,806,454,63274.880952380954,68065.44665012407,54770.044052863435,1100,717,383,68033.04545454546,72169.80474198048,60288.772845953004,160,89,71,30562.5,35000.0,25000.0,0,0,0,#DIV/0!,0.0,0.0
112,Ulster County (East) PUMA,42509,21715,20794,63094.112376202684,69901.75744876813,55984.94565740117,16661,7483,9178,81624.79521037152,96489.93091006282,69504.96404445413,23981,12839,11142,52336.99220216004,57825.46226341616,46012.59199425597,1867,1393,474,35899.03588644885,38378.607322325915,28612.025316455696
113,NYC-Manhattan Community District 10--Central Harlem PUMA,8613,4934,3679,118314.12864274933,130823.66639643292,101537.27099755369,7856,4320,3536,123448.12627291243,138570.33796296295,104973.02601809955,757,614,143,65034.49141347424,76319.3973941368,16580.41958041958,0,0,0,#DIV/0!,0.0,0.0
114,NYC-Brooklyn Community District 4--Bushwick PUMA,12161,6126,6035,57591.52224323658,61904.69507019262,53213.31234465617,9308,4440,4868,59772.894499355396,65608.36981981983,54450.480690221855,2446,1279,1167,55406.54129190515,62116.4972634871,48052.61353898886,407,407,0,20835.380835380834,20835.380835380834,0.0
115,"NYC-Brooklyn Community District 9--Crown Heights South, Prospect Lefferts & Wingate PUMA",7141,3968,3173,61085.09732530458,59464.465725806454,63111.78064922786,5331,2315,3016,65104.04802100919,66078.61771058316,64355.99469496021,1556,1460,96,43985.15424164524,45167.739726027394,26000.0,254,193,61,81488.58267716535,88280.31088082901,60000.0
116,Oneida County (Central)--Greater Utica & Rome Cities PUMA,38563,21572,16991,59536.33067966704,68999.48729834972,47521.7809428521,15691,7733,7958,84929.02491874323,113084.28940902626,57569.80648404122,21207,12729,8478,44315.58400528128,47056.18116112813,40200.80915310215,1665,1110,555,14100.66066066066,13511.711711711712,15278.558558558558
117,"NYC-Bronx Community District 9--Castle Hill, Clason Point & Parkchester PUMA",1031,246,785,50886.711930164885,44097.560975609755,53014.267515923566,509,214,295,61781.925343811396,48000.0,71779.66101694915,522,32,490,40262.835249042146,18000.0,41716.73469387755,0,0,0,#DIV/0!,0.0,0.0
118,Erie County (Central) PUMA,47867,25624,22243,51577.1700754173,57258.363643459255,45032.41873847952,16595,8320,8275,62788.77854775535,70953.33653846153,54579.82114803625,30348,16842,13506,46013.70502174773,50897.877330483316,39923.13564341774,924,462,462,32944.48051948052,42498.917748917745,23390.04329004329
119,Livingston & Wyoming Counties PUMA,32373,18984,13389,50726.4627930683,53506.49072903498,46784.71581148704,8518,3596,4922,67005.91570791266,73152.89210233593,62514.951239333604,21956,13901,8055,46071.27482237202,50411.80058988562,38580.567349472374,1899,1487,412,31527.372301211162,34926.01210490921,19260.922330097088
120,Nassau County (East Central)--Oyster Bay Town (Central) PUMA,24379,14561,9818,103143.7310800279,124422.92768353822,71584.71888368303,12834,7371,5463,126774.29795854761,155073.16510649843,88591.8066996156,11143,6788,4355,74465.19608722965,90000.58190925162,50250.68427095293,402,402,0,143666.66666666666,143666.66666666666,0.0
121,Niagara County (North & East) PUMA,33538,18232,15306,56021.48494245334,59335.28861342694,52074.19182020123,11117,5244,5873,68683.04488621031,73402.29405034325,64469.22867359101,21908,12703,9205,50340.60398028118,54297.201605919865,44880.456273764255,513,285,228,24244.054580896685,25059.64912280702,23224.56140350877
122,Westchester County (Southwest)--Yonkers City PUMA,21339,11643,9696,85818.23745255166,99278.0864038478,69655.59086221122,12354,6305,6049,105352.02444552371,125643.89532117367,84201.38039345347,8588,4941,3647,55800.47263623661,63381.50172029954,45529.60213874417,397,397,0,127309.82367758187,127309.82367758187,0.0
123,Sullivan & Ulster (West) Counties PUMA,22439,13795,8644,66761.1194794777,75690.45886190649,52510.74502545118,7117,4503,2614,104970.29366306028,120086.96424605818,78929.60214231063,13580,7801,5779,47651.56259204713,52158.99500064094,41567.03581934591,1742,1491,251,59627.41676234214,64725.66063044936,29342.629482071712
124,"NYC-Brooklyn Community District 12--Borough Park, Kensington & Ocean Parkway PUMA",12831,8141,4690,80856.2403553893,89917.02370716128,65128.34328358209,5986,2667,3319,94581.60875375877,122499.92875890514,72147.69508888219,5479,4190,1289,67131.97846322322,73697.46539379474,45790.32583397983,1366,1284,82,75757.5402635432,75167.28971962616,85000.0
125,NYC-Brooklyn Community District 11--Bensonhurst & Bath Beach PUMA,13246,7291,5955,79028.68262116866,76570.29214099575,82038.61125104954,6082,2950,3132,102715.63465965143,96065.30508474576,108979.51468710089,6843,4020,2823,59308.40859272249,64336.15671641791,52148.80977683316,321,321,0,50623.052959501554,50623.052959501554,0.0
126,"NYC-Bronx Community District 7--Bedford Park, Fordham North & Norwood PUMA",1224,782,442,59126.72385620915,60565.358056265984,56581.44796380091,387,318,69,52318.11369509044,50868.270440251574,59000.0,837,464,373,62274.79091995221,67211.20689655172,56134.048257372655,0,0,0,#DIV/0!,0.0,0.0
127,NYC-Manhattan Community District 11--East Harlem PUMA,6506,3221,3285,115719.93544420534,123704.8121701335,107890.62404870625,5676,2770,2906,124002.0260747005,134910.9025270758,113603.68203716449,718,451,267,60499.1643454039,54878.04878048781,69994.00749063671,112,0,112,50000.0,0.0,50000.0
128,Westchester County (Southeast) PUMA,23141,14014,9127,167808.3544358498,211681.46853146853,100443.63208063986,17370,10776,6594,197603.29591249282,248347.0554936897,114677.18835304823,5707,3238,2469,78904.4822148239,89659.11982705374,64800.1822600243,64,0,64,9000.0,0.0,9000.0
129,Niagara County (Southwest)--Greater Niagara Falls & North Tonawanda Area PUMA,29577,17213,12364,54994.46427967677,59030.47173647824,49375.5871886121,9416,5134,4282,72544.14294817332,78642.99766264121,65231.78421298459,19419,11402,8017,47013.36938050363,51168.247675846345,41104.18610452788,742,677,65,41163.07277628032,42714.91875923191,25000.0
130,Erie County (Northeast) PUMA,41809,22787,19022,67988.8358487407,81866.94334488963,51363.852381453056,17194,8899,8295,88514.7307200186,108540.79784245421,67030.46654611212,24112,13493,10619,54045.7348208361,65510.98184243682,39477.453620868255,503,395,108,34735.98409542743,39640.0,16800.0
131,Monroe County (Central)--Greece & Gates Towns PUMA,37302,19054,18248,54378.836550319014,58008.181694132465,50589.18604778606,13209,5906,7303,68475.44030585207,74094.95208262783,63930.891962207315,22755,12358,10397,47062.868380575695,50875.74097750445,42530.841877464656,1338,790,548,39635.052316890884,49317.3417721519,25677.007299270073
132,NYC-Brooklyn Community District 10--Bay Ridge & Dyker Heights PUMA,19053,9140,9913,80797.35039101454,94412.49912472648,68243.88933723394,11531,4947,6584,90745.07995837308,113673.32565191024,73517.55391859052,6872,3871,3001,65925.26193247963,72021.77731852235,58061.346217927356,650,322,328,61556.92307692308,67677.01863354037,55548.78048780488
133,"NYC-Bronx Community District 10--Co-op City, Pelham Bay & Schuylerville PUMA",9455,4451,5004,68078.33527234268,75746.41653560997,61257.665867306154,2898,1303,1595,93253.96825396825,89334.76592478895,96455.67398119123,6557,3148,3409,56951.45035839561,70122.01397712833,44789.2519800528,0,0,0,#DIV/0!,0.0,0.0
134,"NYC-Manhattan Community District 1 & 2--Battery Park City, Greenwich Village & Soho PUMA",48853,26106,22747,187816.2453278202,235415.93476595418,133187.6133116455,45551,24013,21538,194756.0530614037,247318.93695081832,136153.00120716874,3254,2093,1161,93428.29133374308,98852.7281414238,83649.35400516796,48,0,48,800.0,0.0,800.0
135,Albany County (East Central)--Albany City PUMA,18233,9660,8573,64158.10179345143,67830.43581780538,60020.13997433804,10588,5302,5286,75978.51057801285,83696.79554884949,68236.8634127885,7361,4074,3287,47643.553864964,48318.99852724595,46806.38880438089,284,284,0,51514.08450704225,51514.08450704225,0.0
136,"NYC-Queens Community District 8--Briarwood, Fresh Meadows & Hillcrest PUMA",9770,5719,4051,78031.32036847492,82299.45445007869,72005.78128857072,5291,2305,2986,83763.33396333396,91126.10845986985,78079.74547890155,4299,3331,968,71963.92184228891,75850.16511558091,58590.90909090909,180,83,97,54451.666666666664,96000.0,18900.0
137,NYC-Queens Community District 4--Elmhurst & South Corona PUMA,1107,1032,75,58973.53206865402,57372.77131782946,81000.0,589,589,0,62901.52801358234,62901.52801358234,0.0,518,443,75,54507.142857142855,50021.89616252822,81000.0,0,0,0,#DIV/0!,0.0,0.0
138,Nassau County (Central)--Hempstead Town (North Central)--Meadowbrook Corridor PUMA,5521,3109,2412,81700.12678862525,104144.00128658733,52770.605306799334,2593,1688,905,115677.47782491322,125979.26540284361,96462.65193370165,2758,1421,1337,54464.72081218274,78205.98170302603,29231.86237845924,170,0,170,5300.0,0.0,5300.0
139,"NYC-Brooklyn Community District 6--Park Slope, Carroll Gardens & Red Hook PUMA",33487,17468,16019,135998.68336966584,171331.61667048317,97469.70659841438,31459,15933,15526,139139.8130900537,179625.17730496454,97593.16179312121,2028,1535,493,87272.4506903353,85246.07817589576,93581.7444219067,0,0,0,#DIV/0!,0.0,0.0
140,"NYC-Bronx Community District 4--Concourse, Highbridge & Mount Eden PUMA",511,364,147,76705.08806262231,75818.68131868132,78900.0,295,216,79,87255.25423728813,112694.44444444444,17700.0,216,148,68,62296.2962962963,22000.0,150000.0,0,0,0,#DIV/0!,0.0,0.0
141,NYC-Manhattan Community District 8--Upper East Side PUMA,67650,32157,35493,166377.33481152993,207842.13919208883,128809.8225002113,64955,30364,34591,170636.1758140251,217052.68640495325,129891.73571160129,2600,1793,807,65109.192307692305,51863.85945343001,94537.79429987608,95,0,95,26000.0,0.0,26000.0
142,Orange County (Northeast)--Greater Newburgh City PUMA,27684,14758,12926,67304.96413090594,74801.47242173736,58745.9768683274,10706,5000,5706,82046.67009153745,91951.5,73367.35892043464,16618,9408,7210,58058.188530509084,66374.32291666667,47206.84424410541,360,350,10,55744.444444444445,56322.857142857145,35500.0
143,"NYC-Bronx Community District 12--Wakefield, Williamsbridge & Woodlawn PUMA",1949,1143,806,70507.48075936378,65351.42607174103,77819.35483870968,1201,757,444,69106.64446294754,63062.98546895641,79410.81081081081,598,297,301,80548.49498327759,79979.79797979798,81109.63455149502,150,89,61,41693.333333333336,36000.0,50000.0
144,NYC-Queens Community District 10--Howard Beach & Ozone Park PUMA,7398,4637,2761,67602.32900783996,71825.19516929048,60510.17747193046,2601,1036,1565,70271.06113033449,72116.24517374518,69049.58466453674,4563,3367,1196,66342.75695814157,72383.72438372439,49336.120401337794,234,234,0,62500.0,62500.0,0.0
145,Suffolk County (Central)--Islip Town (Northwest) PUMA,7269,4129,3140,61291.9548768744,57978.02857834827,65649.66242038217,3031,1159,1872,68162.51732101616,69621.04400345126,67259.50854700855,4042,2774,1268,55278.2360217714,51623.824801730356,63272.9810725552,196,196,0,79061.22448979592,79061.22448979592,0.0
146,Capital Region,318419,173635,144784,509439.3200053104,561360.378588786,445915.90691006486,137279,65099,72180,641226.5214359555,745337.8197136561,550403.462674739,171102,101011,70091,412852.9309027536,457169.15670431353,346535.7863556661,10038,7525,2513,308732.2095841659,328609.80488285713,197640.146496706
147,Central NY,228811,127379,101432,353076.8486457519,390118.0680097565,305476.0809775458,86165,42385,43780,459212.1215382719,530221.436495888,389497.28026276856,132793,77055,55738,290152.70302859845,328531.0338913548,236755.75224165528,9853,7939,1914,194887.63661705222,208226.5150330711,113535.15674726163
148,Finger Lakes,329713,182414,147299,589752.2017466464,671221.8750144498,489542.25948178093,138894,68793,70101,730674.400084976,873755.6761403754,597324.4561461377,178007,103937,74070,477321.30142175005,544037.875857566,383217.6540159204,12812,9684,3128,387313.25408919726,431791.372661529,462345.53753377055
149,Long Island,608799,346612,262187,2383310.3786121886,2728025.9506386835,1909240.2673734385,327384,174944,152440,2829105.792793166,3310782.639602211,2235027.3704931056,273780,167031,106749,1768244.6544400565,1960635.277264505,1467939.8790369735,7635,4637,2998,1324436.57564273,1491251.8617275055,462678.9382933711
150,Mid-Hudson,448025,254406,193619,1662540.3184286475,1951082.291588148,1272095.2610926745,239076,129231,109845,2071003.3272898938,2527487.4276269246,1533198.0514987193,197009,115496,81513,1106506.4170146107,1248882.5660782696,913468.2316102843,11940,9679,2261,1050135.5974911586,1063597.1238408866,435083.6512556322
151,Mohawk Valley,140051,78160,61891,212545.0077922298,232202.4413952725,187898.0959130866,42942,19193,23749,289720.85236351826,341659.9705228916,245061.98466754612,90025,53567,36458,181820.4218277121,198750.1680678343,157121.80615742155,7084,5400,1684,111200.97739202311,115005.8903343736,101825.32150736367
152,New York City,841049,456905,384144,4726343.996712139,5212616.930486816,4142600.772016627,628895,318264,310631,5067414.560910416,5682352.452872093,4350159.590706718,197900,128440,69460,3331409.302409441,3464660.2942723534,2892011.567222688,14254,10201,4053,1863825.3160161502,1739312.0846001836,900195.5523020781
153,North Country,114245,65536,48709,159441.02280972427,178083.89907253662,134619.51685350508,30216,13312,16904,214950.23952438158,256674.32935582282,181103.9704822299,78326,47720,30606,141410.2428625931,160572.0965260018,111609.24156584425,5703,4504,1199,122759.98382199067,136004.4220359628,79120.04119241193
154,Southern Tier,177408,101021,76387,318264.86034812045,345184.55692453036,283060.20439252275,60070,30336,29734,430595.766503036,509593.94844013744,351703.94585003186,108636,63679,44957,260843.96968084527,276603.5547239169,238720.94791121103,8702,7006,1696,181152.1310298757,180463.34404492885,139856.20738231833
155,Western NY,386262,214187,172075,627314.8901478205,695686.6954970433,543010.4886985037,148555,73929,74626,784125.7381821243,883137.7152310462,682758.6182769418,228191,133211,94980,530826.556598852,596476.0425242217,443034.6465303337,9516,7047,2469,372642.96590192465,414261.4017080486,256691.82917105613
