,puma,Total_geo,Total_geo_m,Total_geo_f,Total_Avg_PINCP_mf_t,Total_Avg_PINCP_m,Total_Avg_PINCP_f,Total_BABS,Total_BABS_m,Total_BABS_f,BABS_Avg_PINCP_mf_t,BABS_Avg_PINCP_m,BABS_Avg_PINCP_f,Total_HS,Total_HS_m,Total_HS_f,HS_Avg_PINCP_mf_t,HS_Avg_PINCP_m,HS_Avg_PINCP_f,Total_HSINC,Total_HSINC_m,Total_HSINC_f,HSINC_Avg_PINCP_mf_t,HSINC_Avg_PINCP_m,HSINC_Avg_PINCP_f
0,Total Geo,1118392,665774,452618,65408.70995768925,69964.37702884161,58707.59624009651,503269,261065,242204,93854.82425899469,108938.20569206902,77596.86413519182,492133,313266,178867,43617.3041596479,46847.05689094891,37960.74526883103,122990,91443,31547,36204.89185299618,37891.586660542634,31315.79199289948
1,Nassau County (Central)--Hempstead Town (Northeast) PUMA,6099,3714,2385,76597.27824233481,89328.43295638126,56771.907756813416,2508,1279,1229,96537.40031897927,124615.16810007818,67317.3311635476,3325,2169,1156,62913.38345864662,72161.82572614108,45560.55363321799,266,266,0,59639.0977443609,59639.0977443609,0.0
2,"Chenango, Delaware & Broome (East) Counties PUMA",1139,736,403,44026.083406496924,45490.09375,41352.357320099254,329,248,81,51047.74772036474,58950.43951612903,26851.85185185185,810,488,322,41174.07407407407,38649.59016393442,45000.0,0,0,0,#DIV/0!,0.0,0.0
3,Cayuga & Onondaga (South) Counties PUMA,196,0,196,85765.30612244898,0.0,85765.30612244898,166,0,166,85000.0,0.0,85000.0,0,0,0,#DIV/0!,0.0,0.0,30,0,30,90000.0,0.0,90000.0
4,NYC-Brooklyn Community District 5--East New York & Starrett City PUMA,10443,5776,4667,40468.57224935363,41386.32271468144,39332.74051853439,1903,650,1253,61678.56016815554,63381.53846153846,60795.1316839585,6172,3418,2754,38750.298120544394,41831.27559976595,34926.48511256355,2368,1708,660,27902.094594594593,32125.351288056205,16972.81818181818
5,"NYC-Staten Island Community District 1--Port Richmond, Stapleton & Mariner's Harbor PUMA",12873,7637,5236,48917.55224112484,50210.92182794291,47031.10007639419,3947,1930,2017,66194.22346085634,60793.57512953368,71361.92364898363,6996,4367,2629,43632.59576901086,49382.73414243187,34081.110688474706,1930,1340,590,32742.699481865286,37667.76865671642,21556.949152542373
6,"NYC-Queens Community District 5--Ridgewood, Glendale & Middle Village PUMA",24835,12898,11937,49958.67875981478,55573.277252287175,43892.071458490405,8283,3066,5217,58360.80043462513,67996.38290932811,52698.02568525973,13899,8074,5825,47119.44578746673,53024.30270002477,38934.7565665236,2653,1758,895,38600.8669430833,45613.765642775885,24825.81005586592
7,"Otsego, Schoharie, Oneida (South) & Herkimer (South) Counties PUMA",342,128,214,91596.49122807017,118656.25,75411.21495327103,280,98,182,102492.85714285714,136000.0,84450.54945054946,62,30,32,42387.096774193546,62000.0,24000.0,0,0,0,#DIV/0!,0.0,0.0
8,Erie County (Northwest) PUMA,1109,1028,81,54340.847610459874,55707.198443579764,37000.0,959,878,81,54863.39937434828,56511.38952164009,37000.0,150,150,0,51000.0,51000.0,0.0,0,0,0,#DIV/0!,0.0,0.0
9,NYC-Manhattan Community District 7--Upper West Side & West Side PUMA,13987,8179,5808,214706.01458497177,263753.7016750214,145635.5888429752,12143,6335,5808,237100.14213950423,320955.88413575373,145635.5888429752,1656,1656,0,66356.28019323671,66356.28019323671,0.0,188,188,0,75000.0,75000.0,0.0
10,"NYC-Manhattan Community District 6--Murray Hill, Gramercy & Stuyvesant Town PUMA",9089,4003,5086,126798.04708988887,125447.33949537846,127861.13841918993,7056,3203,3853,146448.90164399092,145708.9291289416,147064.04100700753,1077,84,993,65760.44568245126,70000.0,65401.81268882175,956,716,240,50523.012552301254,41312.849162011174,78000.0
11,Saratoga County (South & Central) PUMA,2142,1036,1106,89706.4472455649,85873.36872586873,93296.92585895117,1836,934,902,97642.81590413944,92521.20985010707,102946.11973392461,306,102,204,42088.23529411765,25000.0,50632.35294117647,0,0,0,#DIV/0!,0.0,0.0
12,Nassau County (South Central)--Hempstead Town (Southeast) PUMA,3983,2049,1934,88364.54933467235,109576.37872132748,65891.41675284384,2524,1327,1197,115924.72266244057,142001.50715900527,87015.87301587302,1217,542,675,45260.47658175842,63258.302583025834,30808.88888888889,242,180,62,17685.95041322314,10000.0,40000.0
13,Columbia & Greene Counties PUMA,959,561,398,84827.52867570386,82288.05704099822,88407.0351758794,840,490,350,91065.0,86466.5306122449,97502.85714285714,74,26,48,56486.48648648649,120000.0,22083.333333333332,45,45,0,15000.0,15000.0,0.0
14,NYC-Staten Island Community District 2--New Springville & South Beach PUMA,15260,9688,5572,77622.20124508519,76350.67609413707,79832.99371859296,8290,4540,3750,95072.42352231605,95832.9845814978,94151.6376,6569,4747,1822,55190.68351347237,57043.77501579945,50362.67837541163,401,401,0,84331.17206982544,84331.17206982544,0.0
15,Nassau County (Northeast)--Oyster Bay Town (North) & Glen Cove City PUMA,10405,6118,4287,107545.40605478136,117536.35665250082,93287.26848612083,5216,2192,3024,170391.55866564417,238986.2454379562,120669.48412698413,3476,2234,1242,34015.85155350978,38380.08057296329,26165.8615136876,1713,1692,21,65387.320490367776,64709.50354609929,120000.0
16,NYC-Brooklyn Community District 18--Canarsie & Flatlands PUMA,15204,8641,6563,59179.07248092607,65146.68765189214,51321.97013560872,7114,4141,2973,76139.19004779309,83947.9710214924,65262.5798856374,6743,3291,3452,48898.97968263384,57726.94621695533,40482.74623406721,1347,1209,138,21068.00296956199,20946.732837055417,22130.434782608696
17,Putnam County PUMA,3895,2435,1460,54384.69833119384,55086.981519507186,53213.42465753425,1203,592,611,88749.04405652535,79326.01351351352,97879.05073649755,2296,1447,849,43508.405923344944,56674.36074637181,21068.904593639574,396,396,0,13050.505050505051,13050.505050505051,0.0
18,Nassau County (Northwest)--North Hempstead Town (North) PUMA,9524,6438,3086,116260.9838303234,130703.95930413171,86130.1101749838,5105,3159,1946,146551.4417238002,168664.0044317822,110655.45734840698,3843,2703,1140,87135.05074160812,105215.6862745098,44264.912280701756,576,576,0,42125.868055555555,42125.868055555555,0.0
19,NYC-Queens Community District 3--Jackson Heights & North Corona PUMA,25989,18563,7426,40325.87902574166,40855.395140871624,39002.231349313224,4858,2882,1976,61635.27377521614,62594.24011103401,60236.61943319838,17908,13189,4719,33407.74011614921,34961.801501251044,29064.33778342869,3223,2492,731,46645.76481538939,46906.4606741573,45757.045143638854
20,Rockland County (North)--New City & Congers PUMA,7453,4534,2919,66837.20515228767,70330.84693427438,61410.63035286057,3104,1885,1219,100961.72358247422,109783.58620689655,87320.04101722724,3638,2018,1620,44766.21770203408,47019.3260654113,41959.567901234564,711,631,80,30791.84247538678,27025.356576862123,60500.0
21,"NYC-Bronx Community District 3 & 6--Belmont, Crotona Park East & East Tremont PUMA",13701,7694,6007,32541.413765418583,36245.4834936314,27797.09672049276,3703,2183,1520,43240.91277342695,51645.44205222171,31170.46052631579,7132,3935,3197,31766.79893438026,35317.573062261756,27396.35908664373,2866,1576,1290,20644.80111653873,17231.027918781725,24815.42635658915
22,Orange County (Northwest) PUMA,4507,3192,1315,54098.82671400045,59215.60119047619,41678.48897338403,1711,1095,616,59512.974284044416,59494.70228310502,59545.454545454544,2371,1672,699,54305.23534373682,66166.56698564593,25933.065808297568,425,425,0,31150.58823529412,31150.58823529412,0.0
23,NYC-Brooklyn Community District 2--Brooklyn Heights & Fort Greene PUMA,6922,3518,3404,106874.18549552152,116164.56850483229,97272.66745005875,5737,2560,3177,112289.02074254837,143172.246875,87403.57570034623,1122,958,164,83784.3137254902,43993.7369519833,316219.51219512196,63,0,63,25000.0,0.0,25000.0
24,Dutchess County (Southwest) PUMA,5490,2991,2499,60854.38615664845,58737.41223671013,63388.14725890356,3111,1058,2053,77262.64223722275,84831.37996219282,73362.14320506576,1928,1655,273,41353.371369294604,45702.11480362538,14990.10989010989,451,278,173,31035.920177383592,37032.374100719426,21400.0
25,Westchester County (Northwest) PUMA,9948,5881,4067,61503.38057901086,67707.90681856827,52531.455618391934,5022,2226,2796,88683.16009557946,116792.45283018867,66304.3025751073,3333,2347,986,38594.599459945995,46499.87217724755,19777.484787018257,1593,1308,285,23749.529190207155,22228.593272171252,30729.824561403508
26,Nassau County (Southeast)--Oyster Bay Town (South) PUMA,5062,3061,2001,68871.38087712367,75385.07023848416,58907.16141929036,1845,1062,783,95804.60704607047,115936.44067796611,68499.36143039592,2992,1923,1069,53496.73462566845,54479.459178367135,51728.93358278765,225,76,149,52467.555555555555,37700.0,60000.0
27,Westchester County (South Central)--New Rochelle & Mount Vernon Cities PUMA,11831,7663,4168,95305.71760628857,101425.92835704032,84053.51631477928,5256,2716,2540,151007.401065449,187667.89396170838,111806.65354330708,4449,3264,1185,53729.64396493594,54882.913602941175,50553.04303797468,2126,1683,443,44602.0032925682,52515.18657159834,14539.051918735891
28,Saratoga County (Outer) PUMA,1964,1501,463,92043.02443991853,88739.17388407729,102753.7796976242,1433,970,463,110766.2247034194,114590.72164948453,102753.7796976242,275,275,0,58096.36363636364,58096.36363636364,0.0,256,256,0,23703.125,23703.125,0.0
29,NYC-Queens Community District 9--Richmond Hill & Woodhaven PUMA,20482,13399,7083,50034.46099013768,51315.13023359952,47611.802908372156,8141,4738,3403,64326.735044834786,66883.26931194597,60767.27005583309,9727,6427,3300,41227.21291251157,44576.47424926093,34704.27272727273,2614,2234,380,38295.631216526395,37683.75111906893,41892.84210526316
30,Erie County (South) PUMA,1241,761,480,60279.37147461724,75780.42049934297,35703.75,827,590,237,72980.53204353084,85028.64406779662,42987.3417721519,414,171,243,34907.729468599035,43871.34502923977,28600.0,0,0,0,#DIV/0!,0.0,0.0
31,"NYC-Queens Community District 12--Jamaica, Hollis & St. Albans PUMA",14512,8859,5653,39140.64153803749,39349.31143469918,38813.62816203786,5803,2959,2844,46953.28623125969,44609.46265630281,49391.88466947961,7295,5031,2264,33006.918437285814,35124.89564698867,28300.40636042403,1414,869,545,38722.48939179632,45895.05178365938,27285.871559633026
32,NYC-Brooklyn Community District 1--Greenpoint & Williamsburg PUMA,7697,4511,3186,84996.27855008445,96281.12081578364,69018.27369742624,4087,2284,1803,117100.42671886469,134700.75481611208,94804.72545757072,3291,2062,1229,50659.164995442115,59332.01357904947,36107.973962571195,319,165,154,27923.510971786833,26212.121212121212,29757.14285714286
33,Suffolk County (Central)--Brookhaven Town (Central) PUMA,7154,4756,2398,65532.369024322055,69332.12783851977,57996.23352793995,1416,611,805,170508.4745762712,302200.65466448443,70553.29192546583,3201,1954,1247,50079.8712902218,43385.05629477994,60570.38331996792,2537,2191,346,26437.879385100514,27532.90734824281,19503.757225433525
34,St. Lawrence County PUMA,1444,774,670,54856.024930747924,62094.315245478036,46494.17910447761,768,319,449,71955.46875,94100.31347962383,56222.27171492205,367,304,63,53214.44141689374,56868.42105263158,35582.53968253968,309,151,158,14306.148867313916,5000.0,23200.0
35,Genesee & Orleans Counties PUMA,552,552,0,95726.44927536232,95726.44927536232,0.0,360,360,0,130069.44444444444,130069.44444444444,0.0,32,32,0,38000.0,38000.0,0.0,160,160,0,30000.0,30000.0,0.0
36,Monroe County (Central)--Rochester City (West) PUMA,1328,534,794,37898.26807228916,11953.18352059925,55347.48110831234,313,0,313,43903.25878594249,0.0,43903.25878594249,1015,534,481,36046.48275862069,11953.18352059925,62794.553014553014,0,0,0,#DIV/0!,0.0,0.0
37,Wayne & Seneca Counties PUMA,1323,484,839,47691.68556311414,47921.48760330579,47559.11799761621,767,197,570,61300.0,85685.27918781726,52872.10526315789,515,287,228,29867.961165048542,22000.0,39771.929824561405,41,0,41,17000.0,0.0,17000.0
38,Warren & Washington Counties PUMA,354,283,71,58338.983050847455,59929.32862190813,52000.0,354,283,71,58338.983050847455,59929.32862190813,52000.0,0,0,0,#DIV/0!,0.0,0.0,0,0,0,#DIV/0!,0.0,0.0
39,Erie County (North Central) PUMA,3982,2604,1378,109286.26318432948,140904.9846390169,49536.51669085631,3438,2455,983,121949.65095986039,148133.43380855396,56556.78535096643,380,78,302,33450.0,28000.0,34857.615894039736,164,71,93,19536.585365853658,15000.0,23000.0
40,"Clinton, Franklin, Essex & Hamilton Counties PUMA",1121,614,507,44833.71989295272,40991.042345276874,49487.376725838265,559,176,383,69011.98568872988,91134.09090909091,58846.21409921671,562,438,124,20784.519572953737,20842.237442922375,20580.645161290322,0,0,0,#DIV/0!,0.0,0.0
41,Dutchess County (North & East) PUMA,2542,1856,686,73396.34146341463,73178.6099137931,73985.42274052478,1198,616,582,91643.40567612687,98250.0,84650.85910652921,620,516,104,84554.35483870968,98714.14728682171,14300.0,724,724,0,33647.79005524862,33647.79005524862,0.0
42,Tompkins County PUMA,2833,1351,1482,67942.53794564067,64517.942264988895,71064.41970310391,2422,1351,1071,74747.20891824938,64517.942264988895,87650.79365079365,264,0,264,40000.0,0.0,40000.0,147,0,147,6010.0,0.0,6010.0
43,"NYC-Manhattan Community District 4 & 5--Chelsea, Clinton & Midtown Business District PUMA",14923,8731,6192,106398.84138578034,109456.52388042607,102087.3708010336,13430,8075,5355,112713.5450483991,113634.78761609907,111324.36974789915,1216,379,837,52529.60526315789,73596.30606860158,42990.442054958185,277,277,0,36718.41155234657,36718.41155234657,0.0
44,Onondaga County (Central)--Syracuse City PUMA,4349,2880,1469,36097.682225799035,34225.48611111111,39768.15520762424,1346,823,523,56226.374442793465,62192.831105710815,46837.476099426385,2123,1177,946,29706.227037211494,24760.322854715378,35859.85200845666,880,880,0,20729.31818181818,20729.31818181818,0.0
45,Suffolk County (South Central)--Brookhaven Town (South) PUMA,4066,2728,1338,84301.62321692081,76052.30938416423,101120.85201793721,1086,581,505,143068.13996316757,122702.23752151463,166499.0099009901,2901,2068,833,64532.50603240262,65759.71953578337,61485.834333733495,79,79,0,2400.0,2400.0,0.0
46,Suffolk County (Northwest)--Smithtown Town PUMA,3403,2226,1177,74151.71907140758,73592.58760107816,75209.17587085812,2211,1167,1044,83312.75440976933,87249.44301628106,78912.26053639846,1135,1002,133,55007.75330396476,56184.63073852295,46141.35338345865,57,57,0,100000.0,100000.0,0.0
47,Herkimer (North & Central) & Oneida (Outer) Counties PUMA,102,42,60,53089.705882352944,52000.0,53852.5,102,42,60,53089.705882352944,52000.0,53852.5,0,0,0,#DIV/0!,0.0,0.0,0,0,0,#DIV/0!,0.0,0.0
48,NYC-Queens Community District 2--Sunnyside & Woodside PUMA,23072,14233,8839,54199.48352981969,55008.53326775803,52896.71116642154,10550,5068,5482,75345.12170616114,88196.39976322021,63464.370667639545,10595,7628,2967,36610.08494572912,36276.337178814894,37468.132794068086,1927,1537,390,35140.425531914894,38543.3962264151,21729.23076923077
49,Onondaga County (Central)--Syracuse City (Outer) PUMA,2652,1257,1395,55541.8544494721,54044.731901352425,56890.87455197133,1215,560,655,74374.56625514403,67734.87142857142,80051.25190839695,944,453,491,43797.351694915254,44288.52097130243,43344.19551934827,493,244,249,31617.038539553752,40737.70491803279,22679.518072289156
50,Broome County (West Central)--Greater Binghamton City & Greater Johnson City Village PUMA,1646,1055,591,78875.72296476306,94097.81990521327,51702.605752961084,687,352,335,143979.62154294032,209772.72727272726,74847.76119402985,626,409,217,41976.35782747604,50877.75061124694,25199.078341013825,333,294,39,13928.648648648648,15728.57142857143,360.0
51,Erie County (West Central)--Buffalo City (West) PUMA,2243,1327,916,65146.8568880963,73227.20422004521,53440.93886462882,803,340,463,59423.163138231634,36889.705882352944,75970.41036717063,817,364,453,39372.827417380664,50521.97802197802,30414.12803532009,623,623,0,106324.23756019262,106324.23756019262,0.0
52,"Steuben (North & West), Schuyler & Chemung (North) Counties PUMA",661,290,371,51617.246596066565,66731.03448275862,39803.23450134771,440,254,186,58488.63636363636,67685.03937007874,45930.10752688172,179,36,143,32759.77653631285,60000.0,25902.097902097903,42,0,42,60000.0,0.0,60000.0
53,Monroe County (North & West) PUMA,1587,758,829,28222.810333963454,34011.08179419525,22930.277442702052,292,59,233,19625.342465753423,45000.0,13200.0,907,351,556,32528.11466372657,42192.02279202279,26427.338129496402,388,348,40,24628.865979381444,23896.55172413793,31000.0
54,NYC-Brooklyn Community District 8--Crown Heights North & Prospect Heights PUMA,5098,2533,2565,62244.880345233425,71650.2566127122,52956.84210526316,2587,1120,1467,91644.18245071512,126762.5,64832.651670074985,1826,895,931,36653.28587075575,33726.14525139665,39467.2395273899,685,518,167,19433.576642335767,18013.899613899615,23837.125748502993
55,Cattaraugus & Allegany Counties PUMA,592,304,288,64364.35810810811,82861.84210526316,44839.23611111111,408,120,288,64239.46078431373,110800.0,44839.23611111111,143,143,0,74000.0,74000.0,0.0,41,41,0,32000.0,32000.0,0.0
56,"NYC-Queens Community District 11--Bayside, Douglaston & Little Neck PUMA",14522,8743,5779,73264.50991598953,78045.84467574059,66030.86918151929,8809,4543,4266,73946.7979339312,72655.34888839973,75322.10337552743,4890,3607,1283,76385.43967280163,89256.02994177987,40201.32501948558,823,593,230,47418.06804374241,51155.26138279933,37782.608695652176
57,Chemung (South) & Steuben (East) Counties--Greater Elmira & Greater Corning Cities PUMA,2177,1265,912,96021.54340836013,104041.66007905138,84897.14912280702,1829,1023,806,102946.5281574631,110442.81524926686,93432.00992555832,348,242,106,59625.574712643676,76982.23140495867,20000.0,0,0,0,#DIV/0!,0.0,0.0
58,Suffolk County (Southwest)--Babylon Town (Southeast) PUMA,6185,3540,2645,62211.40662894099,62755.353107344636,61483.40264650284,1659,1127,532,100052.20012055455,80209.05057675244,142088.34586466165,4056,2362,1694,47782.260848126236,55154.21253175275,37503.305785123965,470,51,419,53161.914893617024,29100.0,56090.692124105015
59,Jefferson & Lewis Counties PUMA,763,337,426,68231.84796854522,82891.09792284867,56635.211267605635,318,144,174,113877.35849056604,152000.0,82327.58620689655,284,32,252,54952.112676056335,181400.0,38895.23809523809,161,161,0,1500.0,1500.0,0.0
60,NYC-Brooklyn Community District 3--Bedford-Stuyvesant PUMA,5324,3033,2291,45629.301277235165,51881.17375535773,37352.59711916194,1942,1221,721,57317.91967044284,69662.57166257166,36412.4826629681,2353,863,1490,37824.81937951551,35133.71958285052,39383.4899328859,1029,949,80,41416.13216715257,44233.08746048472,8000.0
61,Schenectady County--Schenectady City PUMA,1555,1088,467,78095.94855305467,94923.89705882352,38890.792291220554,880,599,281,114779.54545454546,148961.60267111854,41914.59074733096,414,228,186,31942.028985507248,30000.0,34322.58064516129,261,261,0,27621.45593869732,27621.45593869732,0.0
62,NYC-Queens Community District 1--Astoria & Long Island City PUMA,21459,13255,8204,52698.59825714152,53348.70690305545,51648.233788395904,9694,4950,4744,72093.62904889623,75831.3393939394,68193.61509274873,9385,6160,3225,36714.105487480025,40324.396103896106,29818.17054263566,2380,2145,235,36731.80672268908,38868.85780885781,17225.531914893618
63,Suffolk County (North Central)--Brookhaven Town (North) PUMA,3230,1820,1410,106563.01547987617,130107.0,76172.90780141843,3074,1749,1325,109036.61027976578,132952.96740994856,77467.01886792453,156,71,85,57820.51282051282,60000.0,56000.0,0,0,0,#DIV/0!,0.0,0.0
64,Fulton & Montgomery Counties PUMA,955,542,413,36420.293193717276,38040.0,34294.67312348668,192,192,0,32576.458333333332,32576.458333333332,0.0,649,236,413,38509.5531587057,45885.59322033898,34294.67312348668,114,114,0,31000.0,31000.0,0.0
65,NYC-Brooklyn Community District 16--Brownsville & Ocean Hill PUMA,4227,2557,1670,66328.2942985569,87162.76886976926,34427.844311377245,1116,687,429,160381.54121863798,222779.91266375547,60456.87645687646,2359,1275,1084,35809.02924968207,42487.05882352941,27954.335793357932,752,595,157,22487.23404255319,26309.915966386554,8000.0
66,"Rockland County (South)--Orangetown, Clarkstown (South) & Ramapo (Southeast) Towns PUMA",5310,1979,3331,81529.00188323917,81875.18948964123,81323.3263284299,3243,1110,2133,93128.27628738822,88721.62162162163,95421.47210501641,1981,783,1198,61955.577990913676,70727.969348659,56222.0367278798,86,86,0,95000.0,95000.0,0.0
67,Oswego County PUMA,640,196,444,69113.390625,111362.24489795919,50462.995495495496,253,71,182,117750.07905138339,250000.0,66158.07692307692,339,77,262,38070.20648967552,33000.0,39560.30534351145,48,48,0,32000.0,32000.0,0.0
68,"NYC-Manhattan Community District 12--Washington Heights, Inwood & Marble Hill PUMA",21707,12297,9410,55961.84088082185,61763.87574205091,48379.73432518597,9892,5402,4490,76278.30064698747,93264.79081821548,55841.54788418708,10689,5769,4920,40956.43465244644,40433.10452418097,41570.07113821138,1126,1126,0,19924.86678507993,19924.86678507993,0.0
69,Monroe County (Central)--Rochester City (East) PUMA,2398,1928,470,62264.55379482902,50033.402489626555,112438.29787234042,522,385,137,77469.34865900384,90446.75324675324,41000.0,1708,1375,333,59257.25995316159,39259.92727272727,141828.82882882882,168,168,0,45595.23809523809,45595.23809523809,0.0
70,Westchester County (Northeast) PUMA,8145,5120,3025,86290.2087170043,99464.84375,63991.32231404959,3745,1939,1806,146206.5821094793,204352.96544610625,83778.1007751938,2071,1325,746,47067.21390632544,47908.07547169811,45573.72654155496,2329,1856,473,24823.486474881924,26692.564655172413,17489.42917547569
71,"NYC-Bronx Community District 1 & 2--Hunts Point, Longwood & Melrose PUMA",10942,6061,4881,32584.719429720342,29331.248968817028,36624.728539233765,1661,460,1201,44183.80493678507,36913.47826086957,46968.4429641965,7047,3846,3201,30201.617709663686,28115.70462818513,32707.841299593878,2234,1755,479,31478.021486123544,30007.69230769231,36865.13569937369
72,"NYC-Queens Community District 7--Flushing, Murray Hill & Whitestone PUMA",29935,17302,12633,50108.738600300654,47367.57600277424,53863.00087073538,13275,7129,6146,66032.28549905839,65041.6047131435,67181.41718190693,13845,8596,5249,38112.74106175514,34236.41228478362,44460.79253191084,2815,1577,1238,34016.19893428064,39046.290424857325,27608.723747980614
73,Onondaga County (North) PUMA,1221,549,672,64162.03112203112,64134.499089253186,64184.52380952381,719,474,245,78728.56745479834,62573.50210970464,109983.67346938775,502,75,427,43298.8047808765,74000.0,37906.32318501171,0,0,0,#DIV/0!,0.0,0.0
74,Suffolk County (Central)--Brookhaven Town (West Central) PUMA,6892,4788,2104,56655.177016831105,59937.54803675856,49185.59885931559,2068,1124,944,67942.30174081239,79858.256227758,53754.23728813559,4144,3153,991,51974.227799227796,53548.7789406914,46964.58123107972,680,511,169,50855.294117647056,55540.117416829744,36689.94082840237
75,Monroe County (South) PUMA,5879,2926,2953,96171.67409423372,118569.55160628844,73978.58584490349,3844,1823,2021,124099.1342351717,159112.29182665935,92516.26125680357,1685,753,932,46675.01483679525,62634.794156706506,33780.47210300429,350,350,0,27739.428571428572,27739.428571428572,0.0
76,"NYC-Brooklyn Community District 15--Sheepshead Bay, Gerritsen Beach & Homecrest PUMA",20005,11443,8562,60934.456885778556,64013.4728655073,56819.39266526513,11200,5548,5652,73750.01160714286,78274.13302090844,69309.13658881812,7060,4814,2246,47943.01416430595,54068.94058994599,34812.91184327694,1745,1081,664,31241.260744985673,35109.5282146161,24943.67469879518
77,Rensselaer County--Troy City PUMA,2781,1523,1258,57847.59079467817,58979.08732764281,56477.74244833068,1562,699,863,70893.69398207427,75468.02575107296,67188.64426419466,1047,652,395,36387.96561604585,38394.17177914111,33076.45569620253,172,172,0,70000.0,70000.0,0.0
78,Suffolk County (Central)--Islip Town (East) PUMA,3635,2502,1133,62028.50068775791,77676.1790567546,27473.78640776699,1628,1553,75,97951.35135135135,99397.81068898905,68000.0,2007,949,1058,32889.2874937718,42129.610115911484,24600.94517958412,0,0,0,#DIV/0!,0.0,0.0
79,Nassau County (West Central)--Hempstead Town (Northwest) PUMA,12299,7491,4808,64332.30506545248,58154.75904418636,73957.09650582363,5193,2545,2648,72429.85172347391,77288.2514734774,67760.43051359517,6158,4056,2102,58726.51835011367,46016.22287968442,83252.1883920076,948,890,58,56389.13502109705,58760.56179775281,20000.0
80,Ontario & Yates Counties PUMA,599,274,325,74378.13021702837,130540.14598540145,27029.23076923077,437,214,223,88467.96338672769,152000.0,27500.0,162,60,102,36370.37037037037,54000.0,26000.0,0,0,0,#DIV/0!,0.0,0.0
81,Suffolk County (West Central)--Babylon Town (Northwest) PUMA,6013,3307,2706,55440.345917179446,66024.85636528576,42505.025868440505,2284,1087,1197,54475.218914185636,60111.4995400184,49356.89223057644,1974,1029,945,63578.470111448834,84928.08551992226,40331.11111111111,1755,1191,564,47542.73504273504,55089.840470193114,31605.49645390071
82,Nassau County (Southwest)--Hempstead Town (Southwest) & Long Beach City PUMA,5349,3292,2057,57458.51561039447,55216.95018226002,61045.8920758386,2033,1215,818,78037.8750614855,74961.48148148147,82607.33496332518,2606,1976,630,49411.35840368381,45592.10526315789,61390.47619047619,710,101,609,28068.450704225354,6000.0,31728.407224958948
83,"NYC-Bronx Community District 8--Riverdale, Fieldston & Kingsbridge PUMA",13456,8231,5225,49621.973097502974,51607.941926861866,46493.454545454544,5933,2747,3186,67344.12101803473,85625.18019657809,51582.01506591337,6245,4206,2039,38862.48198558847,39017.641464574415,38542.422756253065,1278,1278,0,19925.195618153364,19925.195618153364,0.0
84,"Rockland County (West)--Spring Valley, Suffern Villages & Monsey PUMA",9618,6067,3551,43822.10750675816,41881.70100543926,47137.3556744579,2328,1579,749,65883.87886597938,56116.795440152,86474.29906542056,5408,2901,2507,40852.396449704145,42817.73871078938,38578.18109293977,1882,1587,295,25065.67481402763,26007.30938878387,20000.0
85,Chautauqua County PUMA,204,128,76,66661.05882352941,89378.5625,28400.0,128,128,0,89378.5625,89378.5625,0.0,76,0,76,28400.0,0.0,28400.0,0,0,0,#DIV/0!,0.0,0.0
86,Orange County (Southeast) PUMA,4957,2861,2096,80586.35263264072,103897.36106256554,48767.270992366415,2431,1101,1330,111486.69271904566,178381.4259763851,56109.924812030076,2077,1589,488,46326.04718343765,47422.40402769037,42756.147540983606,449,171,278,71766.59242761692,149112.28070175438,24190.64748201439
87,Monroe County (East) PUMA,2427,1533,894,83979.99587968686,104161.21983039791,49373.93736017897,1455,1126,329,112691.09965635739,123855.63943161634,74480.54711246201,744,360,384,47306.45161290323,55102.77777777778,39997.395833333336,228,47,181,20429.385964912282,8100.0,23630.93922651934
88,Broome (Outer West) & Tioga Counties PUMA,670,483,187,47313.59701492537,44932.50517598344,53463.689839572195,333,318,15,36117.117117117115,32018.867924528302,123000.0,267,95,172,55198.9138576779,69320.0,47399.476744186046,70,70,0,70500.0,70500.0,0.0
89,Suffolk County (East) PUMA,8564,4857,3707,50179.37879495563,50073.62569487338,50317.93903425951,1526,702,824,111282.63433813893,123442.02279202279,100923.54368932039,5948,3464,2484,36978.261600538,39560.36374133949,33377.45571658615,1090,691,399,36671.74311926605,28240.520984081042,51273.18295739348
90,"NYC-Queens Community District 14--Far Rockaway, Breezy Point & Broad Channel PUMA",6033,3393,2640,52312.36863915133,47395.67344532862,58631.43939393939,2639,1333,1306,63272.87608942782,49137.07426856714,77700.91883614089,2396,1391,1005,44785.30884808013,46977.713874910136,41750.845771144275,998,669,329,41400.60120240481,44794.9177877429,34498.480243161095
91,NYC-Brooklyn Community District 14--Flatbush & Midwood PUMA,16766,8365,8401,47271.92800906597,49135.79736999402,45416.04570884418,4474,2358,2116,66073.02972731336,71829.91306191687,59657.75047258979,9014,4734,4280,39747.61925893055,44453.97972116603,34542.03271028037,3278,1273,2005,42301.82123245882,24509.717203456403,53598.25436408978
92,Albany County (Outside Albany City) PUMA,5424,2970,2454,77989.1058259587,95239.84848484848,57111.06764466178,3087,1670,1417,108023.03530936185,141530.26946107784,68533.21100917431,1465,879,586,42577.474402730375,42349.26052332196,42919.795221843,872,421,451,31158.02752293578,22047.030878859856,39662.9711751663
93,"NYC-Bronx Community District 5--Morris Heights, Fordham South & Mount Hope PUMA",11255,5847,5408,35226.81474900044,38635.30015392509,31541.64201183432,2201,939,1262,49075.60199909132,66757.18849840255,35919.49286846276,7474,3986,3488,33458.02782981001,35949.222277972905,30611.15252293578,1580,922,658,24301.962025316454,21607.375271149675,28077.659574468085
94,"NYC-Manhattan Community District 9--Hamilton Heights, Manhattanville & West Harlem PUMA",8800,4938,3862,78350.47727272728,88546.5775617659,65313.61988606939,6023,2880,3143,97922.2978582102,127121.52777777778,71166.40152720331,2204,1485,719,35069.056261343016,32812.79461279461,39729.06815020862,573,573,0,39102.96684118674,39102.96684118674,0.0
95,Nassau County (West Central)--Hempstead Town (West Central) PUMA,9541,5453,4088,64801.83418928833,69360.33376123235,58721.232876712325,3887,2311,1576,83316.56804733728,83658.37299870186,82815.35532994923,5476,2964,2512,52834.5507669832,60656.74763832658,43604.85668789809,178,178,0,28656.1797752809,28656.1797752809,0.0
96,Erie County (West Central)--Buffalo City (East) PUMA,1407,992,415,35629.99289267946,34764.1129032258,37699.75903614458,469,416,53,39074.62686567164,29146.634615384617,117000.0,765,470,295,35126.40522875817,40487.234042553195,26585.42372881356,173,106,67,28518.49710982659,31433.962264150945,23905.97014925373
97,NYC-Queens Community District 6--Forest Hills & Rego Park PUMA,19854,10395,9459,70819.63533796716,70044.6657046657,71671.29083412622,14590,6728,7862,78945.3831391364,82333.08561236624,76046.3164589163,4386,2830,1556,50896.69402644779,50966.89045936396,50769.02313624679,878,837,41,35315.489749430526,35771.80406212664,26000.0
98,"NYC-Queens Community District 13--Queens Village, Cambria Heights & Rosedale PUMA",19229,10886,8343,50954.123979406104,50132.165166268605,52026.621119501375,7155,3601,3554,72356.67505241091,66549.9333518467,78240.20821609454,10553,6490,4063,39473.31564484033,42666.97996918336,34371.94191484125,1521,795,726,29929.612097304405,36709.10691823899,22505.785123966944
99,"NYC-Bronx Community District 11--Pelham Parkway, Morris Park & Laconia PUMA",10000,7176,2824,49395.503,49968.3124303233,47939.95042492918,3264,1858,1406,65787.63174019608,65787.03444564047,65788.42105263157,4750,3603,1147,36574.31578947369,37448.26533444352,33829.032258064515,1986,1715,271,53119.93957703927,59133.644314868805,15062.730627306273
100,Madison & Cortland Counties PUMA,720,364,356,62410.416666666664,60149.72527472527,64721.910112359554,664,308,356,66155.8734939759,67813.31168831169,64721.910112359554,56,56,0,18000.0,18000.0,0.0,0,0,0,#DIV/0!,0.0,0.0
101,Nassau County (Central)--Hempstead Town (East Central) PUMA,3530,1868,1662,83808.92351274788,103338.704496788,61858.483754512636,2667,1594,1073,97029.28383952007,113430.67754077792,72664.1192917055,705,178,527,45715.17730496454,52517.97752808989,43417.457305502845,158,96,62,30627.848101265823,30000.0,31600.0
102,Nassau County (West Central)--North Hempstead Town (South) PUMA,15170,8122,7048,80170.88609096901,90989.41664614627,67703.78830874007,8896,3884,5012,99734.44716726619,130049.85633367662,76241.81963288109,5717,3768,1949,53140.12594017841,56397.71762208068,46842.22678296563,557,470,87,45157.2710951526,45522.97872340425,43181.6091954023
103,Westchester County (Central)--White Plains City PUMA,13500,7335,6165,105455.87407407408,132757.10020449897,72973.39334955394,8450,4588,3862,146344.3076923077,185305.8260680035,100058.58881408596,3910,1791,2119,35408.92583120205,43516.582914572864,28556.252949504484,1140,956,184,42628.070175438595,47753.13807531381,16000.0
104,"NYC-Staten Island Community District 3--Tottenville, Great Kills & Annadale PUMA",9527,5562,3965,82379.92337566915,93816.52822725638,66336.94829760403,4865,2369,2496,99700.13771839671,117578.20599409033,82731.73076923077,4294,2825,1469,66565.52398695855,81169.82654867257,38480.326752893125,368,368,0,37934.782608695656,37934.782608695656,0.0
105,Suffolk County (Northwest)--Huntington Town (South) PUMA,3690,2088,1602,78881.32520325204,86237.16954022988,69293.93258426966,2152,1022,1130,92386.06412639405,104152.94520547945,81743.80530973451,1538,1066,472,59985.22756827048,69060.88180112571,39488.09322033898,0,0,0,#DIV/0!,0.0,0.0
106,NYC-Manhattan Community District 3--Chinatown & Lower East Side PUMA,11962,6927,5035,70738.48018725966,85076.93085029595,51012.07547169811,6345,3259,3086,108065.45311268716,145836.0540042958,68177.44653272846,4721,2996,1725,28350.984960813388,31919.6261682243,22152.927536231884,896,672,224,29747.098214285714,27406.25,36769.642857142855
107,NYC-Brooklyn Community District 13--Brighton Beach & Coney Island PUMA,16717,9431,7286,60305.83477896752,59899.86957904782,60831.31622289322,9077,4216,4861,77111.60295251735,79073.70018975332,75409.85393951862,6973,4701,2272,41807.40283952388,46712.62497340991,31657.997359154928,667,514,153,24988.905547226386,23239.10505836576,30867.320261437908
108,NYC-Brooklyn Community District 7--Sunset Park & Windsor Terrace PUMA,12175,7605,4570,45195.55244353183,44456.0067061144,46426.24070021882,4443,2754,1689,67586.4485707855,62774.77523602034,75432.12551805802,4745,2548,2197,30660.34984193888,31703.806907378337,29450.18661811561,2987,2303,684,34980.214261801135,36658.66261398176,29328.947368421053
109,Suffolk County (Northwest)--Huntington Town (North) PUMA,5085,2710,2375,68218.31071779745,62103.69003690037,75195.41473684211,1777,743,1034,116542.82498593135,114819.65006729474,117781.04448742747,1617,774,843,50410.70500927644,53328.165374677,47732.040332147095,1691,1193,498,34464.45890005914,34965.632858340316,33263.85542168675
110,Suffolk County (Southwest)--Islip Town (South) PUMA,2160,1567,593,57871.57407407407,61626.54754307594,47949.07251264755,776,657,119,65981.9587628866,62356.16438356164,86000.0,1152,718,434,58125.520833333336,68079.1086350975,41658.52534562212,232,192,40,29482.758620689656,35000.0,3000.0
111,"NYC-Brooklyn Community District 17--East Flatbush, Farragut & Rugby PUMA",10709,5186,5523,41181.557568400414,38082.47204010798,44091.544450479814,3182,928,2254,55740.351979886866,43371.22844827586,60832.874889086066,6399,3280,3119,34586.013439599934,35949.87804878049,33151.74735492145,1128,978,150,37528.014184397165,40216.35991820041,20000.0
112,Ulster County (East) PUMA,1943,1105,838,92499.19711785897,130837.592760181,41945.584725536995,846,328,518,167636.40661938535,364771.34146341466,42809.65250965251,948,628,320,33933.5864978903,30563.757961783438,40546.875,149,149,0,38500.0,38500.0,0.0
113,NYC-Manhattan Community District 10--Central Harlem PUMA,8165,4404,3761,49131.789344764235,51147.76566757493,46771.15128955065,3846,1393,2453,60743.239729589186,68614.8600143575,56273.134936812065,3912,2604,1308,40003.21063394683,45554.63133640553,28951.2996941896,407,407,0,27149.87714987715,27149.87714987715,0.0
114,NYC-Brooklyn Community District 4--Bushwick PUMA,10468,7211,3257,44748.40275124188,45640.93468312301,42772.33650598711,4017,2499,1518,54930.2215583769,51008.80352140856,61385.836627140976,4634,3281,1353,39014.97194648252,43079.35995123438,29158.90613451589,1817,1431,386,36860.86956521739,42140.04192872118,17289.63730569948
115,"NYC-Brooklyn Community District 9--Crown Heights South, Prospect Lefferts & Wingate PUMA",4756,2868,1888,62724.14844407065,74521.63528591352,44802.96610169492,1868,913,955,57528.078158458244,56536.41840087623,58476.12565445026,2802,1955,847,67346.03854389722,82920.86956521739,31397.048406139314,86,0,86,25000.0,0.0,25000.0
116,Oneida County (Central)--Greater Utica & Rome Cities PUMA,4592,2499,2093,38762.71777003484,42694.27771108443,34068.51409460105,1072,526,546,69280.78358208956,83532.31939163498,55551.282051282054,2608,1468,1140,30748.23619631902,31607.629427792916,29641.57894736842,912,505,407,25809.21052631579,32386.138613861385,17648.64864864865
117,"NYC-Bronx Community District 9--Castle Hill, Clason Point & Parkchester PUMA",14450,9938,4512,40196.615916955016,38791.3161601932,43291.88829787234,3550,2025,1525,57926.90140845071,53058.51851851852,64391.475409836065,9118,6674,2444,34680.20399210353,35580.17680551393,32222.585924713585,1782,1239,543,33101.290684624015,32770.379338175946,33856.35359116022
118,Erie County (Central) PUMA,1907,1223,684,43098.86103828002,49087.02207686018,32391.959064327486,310,117,193,54480.967741935485,104000.0,24461.65803108808,1415,987,428,41264.69116607774,44238.64032421479,34406.542056074766,182,119,63,37971.92307692308,35310.0,43000.0
119,Livingston & Wyoming Counties PUMA,407,326,81,75759.21375921376,86631.9018404908,32000.0,142,142,0,72000.0,72000.0,0.0,187,106,81,95614.97326203209,144226.4150943396,32000.0,78,78,0,35000.0,35000.0,0.0
120,Nassau County (East Central)--Oyster Bay Town (Central) PUMA,7952,5048,2904,90746.44617706237,104785.13074484945,66343.1129476584,5214,3159,2055,102568.12619869581,119044.89078822412,77239.6107055961,2333,1484,849,69801.20017145306,86868.73315363881,39968.19787985866,405,405,0,59208.22222222222,59208.22222222222,0.0
121,Niagara County (North & East) PUMA,303,161,142,33431.51815181518,34489.13043478261,32232.394366197183,161,161,0,34489.13043478261,34489.13043478261,0.0,142,0,142,32232.394366197183,0.0,32232.394366197183,0,0,0,#DIV/0!,0.0,0.0
122,Westchester County (Southwest)--Yonkers City PUMA,17773,10542,7231,62146.958870196366,67119.99620565357,54896.81925044945,6821,3648,3173,90631.68157161707,103972.97149122808,75293.19256224393,8309,4847,3462,41218.79889276688,48415.638539302665,31142.80762564991,2643,2047,596,54427.6201286417,45732.77967757694,84290.60402684564
123,Sullivan & Ulster (West) Counties PUMA,1119,466,653,54507.77479892761,54950.643776824036,54191.73047473201,662,235,427,65401.81268882175,68523.40425531915,63683.84074941452,457,231,226,38726.91466083151,41142.857142857145,36257.5221238938,0,0,0,#DIV/0!,0.0,0.0
124,"NYC-Brooklyn Community District 12--Borough Park, Kensington & Ocean Parkway PUMA",7581,5701,1880,37122.45614035088,38331.79091387476,33455.21276595745,2695,1623,1072,49831.62523191095,57939.26678989526,37556.71641791045,3891,3083,808,28738.11359547674,28927.992215374634,28013.61386138614,995,995,0,35486.54271356784,35486.54271356784,0.0
125,NYC-Brooklyn Community District 11--Bensonhurst & Bath Beach PUMA,24783,14245,10538,57993.93293790098,55899.5773955774,60825.02941734675,12068,6627,5441,69638.54656943984,65042.35400633771,75236.59253813638,10375,5647,4728,46073.46120481928,45763.290242606694,46443.92131979695,2340,1971,369,50792.094017094016,54200.15220700152,32588.075880758806
126,"NYC-Bronx Community District 7--Bedford Park, Fordham North & Norwood PUMA",13610,8835,4775,35076.67156502572,35589.575551782684,34127.66492146597,2477,505,1972,45602.543399273316,57506.930693069306,42554.0060851927,8485,6829,1656,33444.1249263406,36189.544589251724,22122.584541062803,2648,1501,1147,30461.706948640483,25486.00932711526,36973.060156931126
127,NYC-Manhattan Community District 11--East Harlem PUMA,8187,4003,4184,60195.49774032002,56110.332250811894,64103.938814531546,4890,1682,3208,75894.3026584867,78774.11414982165,74384.37655860349,2668,1996,672,39506.559220389805,39972.745490981964,38121.875,629,325,304,25904.451510333864,37926.153846153844,13052.302631578947
128,Westchester County (Southeast) PUMA,7813,5232,2581,87273.64008703444,82231.13532110091,97495.408756296,1779,972,807,253926.9533445756,278460.4938271605,224377.2614622057,2969,1739,1230,39606.466823846415,41994.59459459459,36230.081300813006,3065,2521,544,36718.20554649266,34328.084093613645,47794.48529411765
129,Niagara County (Southwest)--Greater Niagara Falls & North Tonawanda Area PUMA,315,240,75,56214.920634920636,60657.083333333336,42000.0,121,46,75,67851.23966942148,110000.0,42000.0,66,66,0,20000.0,20000.0,0.0,128,128,0,63888.28125,63888.28125,0.0
130,Erie County (Northeast) PUMA,893,732,161,154335.0503919373,165384.15300546447,104099.37888198758,532,465,67,212919.54887218046,217662.79569892472,180000.0,267,267,0,74337.0786516854,74337.0786516854,0.0,94,0,94,50000.0,0.0,50000.0
131,Monroe County (Central)--Greece & Gates Towns PUMA,3249,2425,824,47540.4647583872,49341.17113402062,42241.05582524272,777,556,221,81090.82368082368,89192.44604316547,60708.46153846154,2259,1869,390,36900.132802124834,37486.00321027287,34092.46153846154,213,0,213,38000.0,0.0,38000.0
132,NYC-Brooklyn Community District 10--Bay Ridge & Dyker Heights PUMA,11850,7308,4542,58089.45746835443,58990.6364258347,56639.47600176134,6740,3288,3452,75589.4856083086,90543.8056569343,61345.62572421785,4100,3298,802,33888.71658536585,33296.16070345664,36325.436408977555,1010,722,288,39547.72277227723,32665.927977839336,56800.0
133,"NYC-Bronx Community District 10--Co-op City, Pelham Bay & Schuylerville PUMA",4903,3367,1536,45051.33591678564,53900.772200772204,25652.864583333332,349,313,36,74418.33810888253,82747.60383386581,2000.0,4163,2934,1229,45862.406918087916,53007.46421267893,28804.963384865743,391,120,271,10203.324808184143,500.0,14500.0
134,"NYC-Manhattan Community District 1 & 2--Battery Park City, Greenwich Village & Soho PUMA",9996,5141,4855,145594.63805522208,172589.28224080917,117009.78414006179,8731,4255,4476,151529.4928415989,182823.38425381904,121780.7198391421,1129,750,379,69293.17980513729,73653.33333333333,60664.90765171504,136,136,0,398000.0,398000.0,0.0
135,Albany County (East Central)--Albany City PUMA,3710,1996,1714,45527.412398921835,53933.466933867734,35738.33138856476,2151,1289,862,59651.92933519293,67501.93948797518,47913.341067285386,874,559,315,23931.807780320367,23816.100178890876,24137.14285714286,685,148,537,28728.467153284673,49513.51351351351,23000.0
136,"NYC-Queens Community District 8--Briarwood, Fresh Meadows & Hillcrest PUMA",19387,11588,7799,67736.97704647444,72434.60251984812,60757.09706372612,12884,7403,5481,82295.13148090655,92915.53073078481,67950.51997810618,5978,3955,2023,39555.52024088324,35330.34134007585,47815.81809194266,525,230,295,31358.85714285714,51247.82608695652,15852.203389830509
137,NYC-Queens Community District 4--Elmhurst & South Corona PUMA,23454,16216,7238,34390.97706148205,34895.01948692649,33261.72147001934,4852,1792,3060,44542.54740313273,44593.02455357143,44512.986928104576,15581,12022,3559,32188.93113407355,34080.655132257525,25798.84799100871,3021,2402,619,29443.826547500827,31735.761865112407,20550.080775444265
138,Nassau County (Central)--Hempstead Town (North Central)--Meadowbrook Corridor PUMA,8895,5838,3057,41972.804946599215,43264.67968482357,39505.69185475957,1819,895,924,66585.70643210555,82726.25698324022,50951.731601731604,4268,2948,1320,36677.34301780693,32910.583446404344,45089.77272727273,2808,1995,813,34077.5641025641,40861.55388471178,17430.50430504305
139,"NYC-Brooklyn Community District 6--Park Slope, Carroll Gardens & Red Hook PUMA",5189,2624,2565,94190.0042397379,114564.59603658537,73346.75711500975,3981,2099,1882,110163.524742527,128388.51834206765,89837.13708820404,867,440,427,48377.439446366785,68159.09090909091,27993.53629976581,341,85,256,24186.803519061585,13411.764705882353,27764.453125
140,"NYC-Bronx Community District 4--Concourse, Highbridge & Mount Eden PUMA",12936,8613,4323,41166.53834260977,42376.5006385696,38755.85010409438,1992,1482,510,55460.843373493975,56190.28340080972,53341.17647058824,9204,5804,3400,41528.998261625384,43355.840799448655,38410.470588235294,1740,1327,413,22884.735632183907,22665.787490580256,23588.23244552058
141,NYC-Manhattan Community District 8--Upper East Side PUMA,19066,10484,8582,165625.99753487884,228099.28462418925,89306.96446049871,14554,7187,7367,179623.7507901608,265924.9617364686,95431.16180263336,4512,3297,1215,120474.55673758865,145644.58598726115,52173.66255144033,0,0,0,#DIV/0!,0.0,0.0
142,Orange County (Northeast)--Greater Newburgh City PUMA,4780,2688,2092,71529.79079497908,63916.22023809524,81312.42829827916,1824,691,1133,117699.56140350878,124452.96671490594,113580.75904677846,2080,1202,878,43030.57692307692,40947.58735440932,45882.23234624146,876,795,81,43064.840182648404,46026.163522012575,14000.0
143,"NYC-Bronx Community District 12--Wakefield, Williamsbridge & Woodlawn PUMA",7420,4273,3147,47548.17385444744,49542.944067399956,44839.672704162695,3862,1641,2221,47225.36250647333,44863.80255941499,48970.21611886538,3197,2271,926,52694.74507350641,59937.252311756936,34932.613390928724,361,361,0,5423.822714681441,5423.822714681441,0.0
144,NYC-Queens Community District 10--Howard Beach & Ozone Park PUMA,9718,7231,2487,60610.50113192015,66337.29083114369,43959.750703659025,3382,2496,886,84849.49733885274,94165.34455128205,58605.30474040632,4947,3713,1234,50068.475843945824,52807.06975491517,41828.28200972448,1389,1022,367,39138.30093592512,47529.94129158513,15769.754768392371
145,Suffolk County (Central)--Islip Town (Northwest) PUMA,14215,9340,4875,42369.65670066831,43891.7312633833,39453.51794871795,2919,2283,636,48448.054128126074,41823.42093736312,72227.98742138364,7480,4297,3183,44309.85294117647,50599.34838259251,35819.1328934967,3816,2760,1056,33916.95492662474,35159.60144927536,30669.128787878788
146,Capital Region,18889,10958,7931,71425.60590820054,79293.83190363205,60554.3386710377,12143,6934,5209,91300.92810672816,104159.5197577156,74184.11595315799,4455,2721,1734,37631.89674523008,38242.44762954796,36673.81776239908,2291,1303,988,31794.412920122217,32695.31849577897,30606.275303643724
147,Central NY,9778,5246,4532,49969.90468398445,46785.163553183374,53656.39011473963,4363,2236,2127,71162.02337840936,70399.18067978534,71963.95862717442,3964,1838,2126,35333.2038345106,31721.76278563656,38455.41862652869,1451,1172,279,26233.631977946243,25356.484641638224,29918.279569892475
148,Finger Lakes,19749,11740,8009,68835.08997923945,76229.88057921635,57995.42939193407,8909,4862,4047,101767.66326187002,128146.47429041547,70076.58858413639,9214,5727,3487,43941.000651182985,41609.06932076131,47770.93203326642,1626,1151,475,29461.07011070111,29188.097306689833,30122.526315789473
149,Long Island,172101,104721,67380,71208.57403501432,76532.52119441182,62934.174057583856,71483,39028,32455,101896.3243288614,116576.84718663523,84242.60545370512,79425,49852,29573,51927.68067988669,56087.241234052795,44915.79778852331,21193,15841,5352,39959.22285660359,42215.757212297205,33280.26905829596
150,Mid-Hudson,120624,71947,48677,74307.31178704071,80686.69781922804,64878.265484725845,52734,26379,26355,115513.64620548412,141803.0349520452,89200.31720736103,48845,29955,18890,44356.679271163885,49552.69337339342,36117.049708840656,19045,15613,3432,37025.285324232085,37160.869723947995,36408.47902097902
151,Mohawk Valley,5991,3211,2780,41649.29561008179,45058.44908128309,37711.60071942446,1646,858,788,69645.70473876063,76578.88111888112,62096.637055837564,3319,1734,1585,32483.308225369088,34076.70126874279,30740.1261829653,1026,619,407,26385.964912280702,32130.856219709207,17648.64864864865
152,New York City,744610,441546,303064,62573.23397080351,66270.97025677959,57185.85484914078,336150,170867,165283,89203.45085229808,102772.25132412929,75176.23552936479,334569,216699,117870,41860.056559334545,44790.22176382909,36473.072003054214,73891,53980,19911,35211.84555629238,36963.6772878844,30462.517201546885
153,North Country,3328,1725,1603,54546.754807692305,58645.68115942029,50135.87024329382,1645,639,1006,79059.27051671733,106331.14241001564,61736.48111332008,1213,774,439,38596.042868920034,41630.103359173125,33246.69703872437,470,312,158,9919.36170212766,3193.9102564102564,23200.0
154,Southern Tier,9126,5180,3946,70930.78774928775,75788.56158301159,64553.88241256969,6040,3546,2494,86555.90215231788,89108.98166948675,82925.90216519647,2494,1270,1224,44723.34001603849,52791.41732283465,36352.05065359477,592,364,228,21920.118243243243,26261.53846153846,14989.078947368422
155,Western NY,14196,9500,4696,75095.45886165118,89615.42252631579,45721.597103918226,8156,5716,2440,95616.7000980873,111415.21798460462,58606.729508196724,4635,2696,1939,41149.307011866236,48282.09866468843,31231.820526044354,1405,1088,317,67956.07829181495,77507.89522058824,35172.55520504732
