,puma,Total_geo,Total_geo_m,Total_geo_f,Total_Avg_PINCP_mf_t,Total_Avg_PINCP_m,Total_Avg_PINCP_f,Total_BABS,Total_BABS_m,Total_BABS_f,BABS_Avg_PINCP_mf_t,BABS_Avg_PINCP_m,BABS_Avg_PINCP_f,Total_HS,Total_HS_m,Total_HS_f,HS_Avg_PINCP_mf_t,HS_Avg_PINCP_m,HS_Avg_PINCP_f,Total_HSINC,Total_HSINC_m,Total_HSINC_f,HSINC_Avg_PINCP_mf_t,HSINC_Avg_PINCP_m,HSINC_Avg_PINCP_f
0,Total Geo,4949640,2672664,2276976,77963.27038128025,87904.81821134269,66294.10171648713,2397301,1166921,1230380,105424.79627964948,126530.63746903175,85407.52575627042,2356836,1375207,981629,53053.77338771132,59198.167414796466,44445.82305534983,195503,130536,64967,41513.98703856207,45037.773778880925,34433.761294195516
1,Monroe County (Central)--Rochester City (East) PUMA,34298,18398,15900,50980.34929150388,54848.2454614632,46504.77987421383,16054,8295,7759,61595.35318300735,69389.57926461723,53262.69364608841,16412,9112,7300,43170.72934438216,44078.75987708516,42037.308219178085,1832,991,841,27922.603711790394,32155.196770938444,22935.08917954816
2,NYC-Brooklyn Community District 4--Bushwick PUMA,34010,17868,16142,56252.47427227286,55269.57801656593,57340.46772394994,18478,9212,9266,64174.62604177941,62727.18627876683,65613.63047701273,14245,7880,6365,45458.82134082134,49633.1192893401,40290.9552238806,1287,776,511,61979.02097902098,23975.515463917527,119690.8023483366
3,NYC-Manhattan Community District 10--Central Harlem PUMA,39461,20013,19448,89054.49709840096,112751.0568130715,64669.50894693542,24145,12574,11571,106793.96935183268,127488.4285032607,84305.6684815487,13304,6443,6861,64719.47684906795,96474.93403693932,34898.69115289317,2012,996,1016,37083.101391650096,31987.349397590362,42078.54330708661
4,Ontario & Yates Counties PUMA,44965,24830,20135,68599.71199822084,74255.26540475231,61625.41892227464,19406,9830,9576,90285.91569617644,92994.24516785351,87505.74874686716,23154,12875,10279,50550.067806858424,60346.02796116505,38280.10117715731,2405,2125,280,67385.15592515592,71844.56470588235,33541.42857142857
5,Albany County (Outside Albany City) PUMA,65655,34969,30686,72477.92338740385,83556.94672424147,59852.54480870756,30209,15187,15022,90755.25373233142,108258.64291828538,73059.60923978165,32522,17818,14704,58724.675604206386,67225.3036255472,48423.79216539717,2924,1964,960,36617.2024623803,40712.01629327902,28239.895833333332
6,"Otsego, Schoharie, Oneida (South) & Herkimer (South) Counties PUMA",35362,19483,15879,54181.21938804366,60081.05065954935,46942.324453680965,11812,5599,6213,71762.06061632239,90198.19967851402,55147.8738129728,21355,12282,9073,45497.39077499415,47512.005373717635,42770.23366031081,2195,1602,593,44057.42141230068,51184.107365792755,24804.553119730186
7,NYC-Brooklyn Community District 11--Bensonhurst & Bath Beach PUMA,21171,11545,9626,63143.368286807425,65971.78432221741,59751.090795761476,10178,5035,5143,78640.20436235017,85194.89572989076,72223.15769006417,10197,6015,4182,49754.579778366184,51869.61762261014,46712.505978000954,796,495,301,36508.54271356784,41802.42424242424,27802.65780730897
8,"Rockland County (South)--Orangetown, Clarkstown (South) & Ramapo (Southeast) Towns PUMA",26272,15353,10919,105651.7962088916,122052.3050869537,82591.34994047074,17287,9279,8008,122863.04911204951,150866.2765384201,90415.2534965035,8618,5761,2857,74533.84311905314,81154.84464502691,61182.9191459573,367,313,54,25661.58038147139,20600.0,55000.0
9,Warren & Washington Counties PUMA,42393,23336,19057,52041.50708843441,53656.584676037026,50063.784960906756,12229,4673,7556,73477.51083490065,87439.18681789,64842.92747485442,27991,16933,11058,43938.4787967561,45819.87657237347,41057.51401700127,2173,1730,443,35783.32719742292,39109.115606936415,22795.48532731377
10,Erie County (North Central) PUMA,36195,19712,16483,76092.98162729658,82121.81057224025,68883.11229751866,23428,12210,11218,90085.12805190371,100298.819000819,78968.24745944019,12237,7434,4803,49973.938873907005,52423.533763788,46182.49843847595,530,68,462,60641.50943396227,65000.0,60000.0
11,"NYC-Manhattan Community District 4 & 5--Chelsea, Clinton & Midtown Business District PUMA",54844,32281,22563,148046.09109474145,157044.87438431274,135171.48561804724,46394,26855,19539,163029.27296633186,172733.67938931298,149691.23957213777,7851,4915,2936,58474.15997962043,68855.24516785351,41095.74250681199,599,511,88,161567.7796327212,180781.01761252448,50000.0
12,Nassau County (Southeast)--Oyster Bay Town (South) PUMA,37197,20782,16415,95202.08565206871,112364.2647483399,73474.12915016753,21306,10835,10471,110137.97240214024,132600.17074296263,86894.92789609397,15207,9398,5809,76346.40889064247,93028.17620770377,49358.07195730763,684,549,135,49170.3216374269,43993.6247723133,70222.22222222222
13,Nassau County (Central)--Hempstead Town (Northeast) PUMA,30181,18010,12171,81335.22878632252,90851.87007218212,67253.00796976419,13499,7137,6362,98423.0980072598,115629.56984727476,79120.5847217856,15596,9859,5737,69712.8840728392,78464.64550157217,54673.03468711871,1086,1014,72,35840.699815837936,36894.47731755424,21000.0
14,NYC-Brooklyn Community District 16--Brownsville & Ocean Hill PUMA,20006,8286,11720,46543.79386184145,45856.99493120927,47029.35836177474,4787,2018,2769,71220.50971380823,69077.75024777008,72782.1162874684,13699,5549,8150,39460.8482370976,39313.490719048474,39561.17791411043,1520,719,801,32663.42105263158,31184.42280945758,33991.011235955055
15,NYC-Brooklyn Community District 2--Brooklyn Heights & Fort Greene PUMA,48309,23532,24777,107052.66244385105,113282.458354581,101135.90265165274,39816,18956,20860,119966.93716094033,128849.46243933319,111895.16586768936,7487,3934,3553,48350.87484973955,52294.83985765125,43983.98536448072,1006,642,364,32803.67793240557,27359.03426791277,42406.593406593405
16,Onondaga County (Central)--Syracuse City PUMA,28832,13268,15564,49954.6455327414,54225.587880615014,46313.75224877924,10072,4259,5813,70171.95194598888,82627.586287861,61046.10528126613,17130,8207,8923,40208.274372446,42031.62056780797,38531.23725204528,1630,802,828,27455.644171779142,28180.423940149627,26753.623188405796
17,NYC-Staten Island Community District 2--New Springville & South Beach PUMA,24829,14957,9872,83629.44218454226,93360.87383833657,68885.41632901135,11802,6677,5125,102387.29876292153,114404.74314812041,86730.62048780487,12776,8059,4717,67313.16687539135,77566.95867973694,49794.551621793515,251,221,30,32141.43426294821,33511.31221719457,22050.0
18,Nassau County (West Central)--Hempstead Town (Northwest) PUMA,28854,16707,12147,107491.37762528592,114756.7366971928,97498.5930682473,16965,8858,8107,140007.2148541114,153291.02506209078,125492.84568891082,11155,7115,4040,60293.653966831014,71065.46732255798,41322.99752475248,734,734,0,73239.9182561308,73239.9182561308,0.0
19,"NYC-Manhattan Community District 9--Hamilton Heights, Manhattanville & West Harlem PUMA",36154,20247,15907,69962.15799081705,79464.47325529708,57867.27038410763,22896,12917,9979,89010.60403563941,101315.36115197027,73083.10151317768,11256,5967,5289,36762.930881307744,39482.14345567287,33695.140858385326,2002,1363,639,38771.98801198801,47422.39178283199,20320.500782472613
20,Monroe County (Central)--Rochester City (West) PUMA,22527,12402,10125,45543.29293736405,49017.373004354136,41287.93086419753,5813,2622,3191,54579.287803199724,51390.23646071701,57199.686618614855,14031,8137,5894,45865.0388425629,53054.8433083446,35939.10756701731,2683,1643,1040,24283.265001863587,25234.936092513693,22779.80769230769
21,"Chenango, Delaware & Broome (East) Counties PUMA",30504,17025,13479,49727.48360870706,53143.193538913365,45413.18272868907,8779,3540,5239,69929.43159813191,76137.50282485876,65734.62874594388,20410,12702,7708,41570.82508574228,46958.24358368761,32692.907368967306,1315,783,532,41457.140684410646,49517.87994891443,29593.30827067669
22,Dutchess County (North & East) PUMA,37872,21184,16688,75057.63624841571,85600.75009441088,61674.04781879194,15454,7634,7820,102886.51287692507,125248.34031962274,81056.56521739131,21626,12994,8632,56361.85286229538,63898.11143604741,45017.30421686747,792,556,236,42541.919191919194,48432.374100719426,28664.406779661018
23,NYC-Brooklyn Community District 10--Bay Ridge & Dyker Heights PUMA,25008,13339,11669,84121.2372040947,85940.53002473949,82041.5776844631,15734,7549,8185,96731.53107919155,101808.20373559411,92049.33170433721,8565,5413,3152,62689.70110916521,65214.280435987435,58354.18464467005,709,377,332,63177.291960507755,65797.61273209548,60201.80722891566
24,NYC-Brooklyn Community District 1--Greenpoint & Williamsburg PUMA,50065,25962,24103,85259.28624787775,91299.27378476235,78753.45060780816,38578,18605,19973,95842.24573591165,106070.78398280032,86314.28528513493,10133,6183,3950,52177.82591532616,57576.80899239851,43726.70886075949,1354,1174,180,31304.357459379615,34810.391822827936,8437.222222222223
25,NYC-Brooklyn Community District 18--Canarsie & Flatlands PUMA,35309,15794,19515,64044.84040896089,68541.61643662151,60405.48193697156,15432,6185,9247,72262.69699326076,72204.58852061439,72301.56375040553,18987,9155,9832,58566.69458050245,67102.7755324959,50618.380797396254,890,454,436,38421.910112359554,47654.18502202643,28808.48623853211
26,Westchester County (Southeast) PUMA,24273,14275,9998,186226.56202364768,236927.17197898423,113836.96339267853,19241,11332,7909,217955.98877397223,281334.01694316976,127148.07181691744,4614,2606,2008,68100.59817945384,70651.68841135841,64789.77091633466,418,337,81,29593.301435406698,29495.54896142433,30000.0
27,Nassau County (Central)--Hempstead Town (North Central)--Meadowbrook Corridor PUMA,23874,11387,12487,65621.5958783614,74972.88311232107,57094.07864178746,9666,3550,6116,76235.06103869232,87025.04225352113,69972.07325049052,12983,7015,5968,59978.87160132481,73056.51176051318,44606.94705093834,1225,822,403,41678.522448979595,39277.23844282238,46576.426799007444
28,Westchester County (Northwest) PUMA,36511,19501,17010,120736.17567308483,142841.35018716988,95393.84714873604,22380,10408,11972,152904.30026809653,205410.51018447347,107257.4047778149,12846,8158,4688,73017.785302818,74648.26918362343,70180.43728668943,1285,935,350,37520.46692607004,41343.31550802139,27308.0
29,Monroe County (South) PUMA,50639,27636,23003,84500.91253776733,100138.57975104936,65713.68604095119,32178,16857,15321,103397.5256386351,130279.81728658717,73820.16186932968,17331,9968,7363,52743.519127574866,54552.28832263243,50294.814613608585,1130,811,319,33467.433628318584,33940.44389642417,32264.890282131662
30,Rockland County (North)--New City & Congers PUMA,27525,13987,13538,86081.30390554042,96660.00857939516,75151.74693455458,16427,7097,9330,101269.37054848725,126602.46583063266,81999.38370846731,10967,6759,4208,63814.81717880916,66209.05459387484,59969.130228136884,131,131,0,45640.0,45640.0,0.0
31,"NYC-Bronx Community District 1 & 2--Hunts Point, Longwood & Melrose PUMA",18526,9710,8816,33661.75105257476,31194.395468589082,36379.31261343013,3452,1179,2273,44844.49594438007,46171.33163698049,44156.269247690274,11610,6494,5116,32339.517657192075,30394.518016630736,34808.405003909305,3464,2037,1427,26949.364896073905,25075.886107020127,29623.700070077084
32,Orange County (Southeast) PUMA,34645,20878,13767,83933.49574253139,92034.05259124437,71648.79857630566,17239,8384,8855,103228.590985556,127999.44298664122,79775.30773574252,16617,11705,4912,65837.68309562496,69546.87056813328,56998.912866449515,789,789,0,43464.51204055767,43464.51204055767,0.0
33,"NYC-Queens Community District 12--Jamaica, Hollis & St. Albans PUMA",40512,18959,21553,52905.85777053713,51148.92768605939,54451.33345705934,12389,3739,8650,62298.25974654936,66133.91815993581,60640.279768786124,25456,13885,11571,50273.270348837206,48602.268635217864,52278.443522599606,2667,1335,1332,34402.9246344207,35666.89138576779,33136.11111111111
34,Nassau County (Northeast)--Oyster Bay Town (North) & Glen Cove City PUMA,26621,16026,10595,163574.2135907742,203465.6183701485,103234.4634261444,18190,10845,7345,201782.20120945576,252748.64914707237,126529.49489448605,8202,4952,3250,77812.35064618386,95679.9071082391,50587.692307692305,229,229,0,200323.1441048035,200323.1441048035,0.0
35,"Rockland County (West)--Spring Valley, Suffern Villages & Monsey PUMA",14747,9239,5508,81572.62561876992,87318.6264747267,71934.40813362382,4784,2484,2300,107833.27132107023,112245.4307568438,103068.13913043478,9071,6167,2904,69317.5107485393,78230.34538673585,50390.013774104686,892,588,304,65356.50224215247,77334.3537414966,42188.81578947369
36,NYC-Queens Community District 2--Sunnyside & Woodside PUMA,27393,15895,11498,82571.29690066805,83847.33979238755,80807.27691772483,19939,10224,9715,95394.0436330809,103909.56240219092,86432.36953165209,6927,5276,1651,47923.30012992638,47064.95451099318,50666.26287098728,527,395,132,52844.40227703985,55866.83544303798,43800.0
37,Suffolk County (Northwest)--Huntington Town (South) PUMA,31693,19502,12191,105928.01943646862,127451.73982155677,71496.42277089656,16735,10111,6624,121203.76097998208,142146.380180002,89236.54740338164,14680,9113,5567,89400.39373297003,113232.50082300011,50388.00071851985,278,278,0,59115.10791366907,59115.10791366907,0.0
38,Westchester County (Southwest)--Yonkers City PUMA,42086,21391,20695,69781.86879247255,76620.77135243794,62712.96496738343,20309,8532,11777,89086.8014180905,104919.70815752461,77616.44731255838,17678,10264,7414,53750.963344269716,60640.96063912704,44212.39681683302,4099,2595,1504,43270.63918028787,46782.71676300578,37210.90425531915
39,"NYC-Manhattan Community District 1 & 2--Battery Park City, Greenwich Village & Soho PUMA",53944,29211,24733,182262.75470858667,203690.46694738284,156955.47689321957,48591,25583,23008,193751.32555411497,220564.48618223038,163937.30050417245,4365,2640,1725,84108.44902634593,97357.18939393939,63832.115942028984,988,988,0,50888.663967611334,50888.663967611334,0.0
40,NYC-Brooklyn Community District 14--Flatbush & Midwood PUMA,23895,13474,10421,70947.99581502406,80042.30295383702,59189.364744266386,14379,6939,7440,86460.02225467697,105223.95013690734,68959.63306451614,9301,6320,2981,47860.928932372866,54019.27215189873,34804.66286481047,215,215,0,32275.3488372093,32275.3488372093,0.0
41,NYC-Queens Community District 9--Richmond Hill & Woodhaven PUMA,19856,11407,8449,64384.684730056404,62919.64320154291,66362.63818203338,8534,5218,3316,77995.12772439653,75755.92564200843,81518.69722557298,10458,5542,4916,52007.867661120676,51171.12053410321,52951.1655817738,864,647,217,79761.11111111111,60030.29366306028,138589.8617511521
42,Erie County (West Central)--Buffalo City (West) PUMA,35635,19158,16477,55111.86502034517,59288.83338553085,50255.25520422407,19654,9580,10074,66326.56660221837,74546.41649269311,58509.79452054795,14466,8270,6196,42882.14917738145,46814.51027811367,37633.50064557779,1515,1308,207,26399.86798679868,26410.39755351682,26333.333333333332
43,Fulton & Montgomery Counties PUMA,34620,19071,15549,47538.53841709994,50751.511719364484,43597.79535661457,8067,3557,4510,68174.36841452832,79171.75991003655,59500.81596452328,23849,13638,10211,42507.927795714706,46050.955418683094,37775.79473117227,2704,1876,828,30343.934911242603,31036.88699360341,28773.91304347826
44,Westchester County (Central)--White Plains City PUMA,41300,22091,19209,132655.46828087166,165353.45661128967,95051.67525639024,30813,16611,14202,154431.1349105897,193209.56414424177,109074.95352767216,10114,5360,4754,70066.45046470239,82025.3619402985,56583.11737484224,373,120,253,30917.426273458444,31360.0,30707.509881422924
45,St. Lawrence County PUMA,28710,16193,12517,52390.83977708116,57530.83986907923,45741.32140289207,9272,4260,5012,71373.24094046591,87216.81924882629,57906.83160415004,18278,10943,7335,44707.37498632236,49227.86438819337,37963.31015678255,1160,990,170,21730.103448275862,21568.40404040404,22671.764705882353
46,Saratoga County (South & Central) PUMA,41411,23763,17648,76345.32104996257,86584.84787274334,62557.816749773345,21840,11767,10073,94887.99038461539,114352.5758477097,72150.0,18932,11530,7402,56302.1434608071,60106.50303555941,50376.14158335585,639,466,173,36416.58841940532,40560.08583690987,25255.49132947977
47,Suffolk County (Central)--Brookhaven Town (West Central) PUMA,34397,20101,14296,73081.10067738466,83497.60111437242,58434.90067151651,12054,6973,5081,92330.2256512361,105348.50853291266,74464.35544184216,21887,12864,9023,63090.966327043454,72432.06856343284,49773.451180316966,456,264,192,43750.21929824561,45545.454545454544,41281.770833333336
48,Suffolk County (North Central)--Brookhaven Town (North) PUMA,30977,18726,12251,97414.81679956097,106276.18711951298,83869.96163578483,16261,8780,7481,112387.1459319845,126082.45785876994,96313.78158000267,14128,9436,4692,80471.75113250283,89276.96057651547,62763.74680306905,588,510,78,90453.23129251701,79816.66666666667,160000.0
49,Niagara County (Southwest)--Greater Niagara Falls & North Tonawanda Area PUMA,33192,18056,15136,56198.281814895156,56745.08750553832,55545.98771141649,9554,4565,4989,85376.14821017375,80043.8926615553,90255.23150932051,21976,12391,9585,43807.865398616676,47749.75627471552,38711.98956703182,1662,1100,562,52303.24909747292,61383.36363636364,34530.78291814947
50,Suffolk County (Central)--Islip Town (East) PUMA,32545,18323,14222,83929.1765248118,94586.21131910714,70199.12108001688,14910,7201,7709,94687.4010731053,113566.91431745591,77051.99117914126,17142,10822,6320,75951.69175125423,83297.52356311218,63373.11708860759,493,300,193,35947.261663286,46206.666666666664,20000.0
51,"NYC-Brooklyn Community District 9--Crown Heights South, Prospect Lefferts & Wingate PUMA",18735,9092,9643,65924.31064851882,72811.89397272328,59430.28310691693,11915,5711,6204,77525.71968107428,88121.57765715287,67771.86009026435,6617,3178,3439,41254.255705002266,37869.66960352423,44381.97150334399,203,203,0,189131.0344827586,189131.0344827586,0.0
52,Westchester County (Northeast) PUMA,36714,21907,14807,157398.99929182327,193039.52526589675,104668.73640845546,26090,15125,10965,191924.36680720584,243142.92694214877,121274.05015959873,10486,6708,3778,73061.54205607477,81853.20661896243,57451.56696664902,138,74,64,38527.536231884056,31200.0,47000.0
53,Chautauqua County PUMA,37297,20566,16731,47143.34423680189,50116.561801030824,43488.61992708147,10107,4102,6005,58690.797467102006,65172.057532910774,54263.46544546211,24914,14959,9955,43757.462470899896,46975.535129353564,38921.787041687596,2276,1505,771,32927.943760984184,40301.926910299,18533.852140077823
54,Erie County (West Central)--Buffalo City (East) PUMA,35887,17140,18747,41481.129656978854,45331.372228704786,37960.931349015846,9567,4013,5554,56635.141632695726,67315.17567904311,48918.365142239825,23386,11740,11646,37441.58470880014,39478.6132879046,35388.114374034005,2934,1387,1547,24265.848670756644,31265.320836337418,17990.303813833227
55,Cayuga & Onondaga (South) Counties PUMA,38916,22498,16418,66870.66322335287,75889.51329007023,54511.905225971495,13420,7086,6334,98205.52682563338,112508.40671747107,82204.54688980107,23290,13717,9573,50472.20008587377,59454.72625209594,37601.28068526063,2206,1695,511,49375.80235720761,55803.669616519175,28054.40313111546
56,Oneida County (Central)--Greater Utica & Rome Cities PUMA,44456,23775,20681,56751.427253913986,66345.76529968454,45721.719452637684,15792,7463,8329,81647.95402735562,108821.00495779177,57300.19570176492,25868,14385,11483,44622.69831451987,49107.41119221411,39004.60245580423,2796,1927,869,28346.56652360515,30528.95692786715,23507.134637514384
57,Suffolk County (Southwest)--Babylon Town (Southeast) PUMA,31190,17608,13582,74777.98076306509,84733.84881871876,61870.97702841997,13402,6647,6755,88381.1669900015,104770.84248533173,72253.53219837157,17384,10731,6653,64428.74597330879,72624.94828068213,51208.627686757856,404,230,174,68840.34653465346,70623.91304347826,66482.75862068965
58,"NYC-Manhattan Community District 6--Murray Hill, Gramercy & Stuyvesant Town PUMA",56140,29154,26986,150022.3991806199,163658.85607463814,135290.41725339065,51571,25736,25835,156625.8924589401,179178.74533727075,134159.46235726727,4320,3169,1151,79492.96064814815,50006.97380877248,160675.49087749782,249,249,0,6000.0,6000.0,0.0
59,NYC-Manhattan Community District 11--East Harlem PUMA,28098,12980,15118,71100.26443163214,79456.15100154083,63926.07421616616,14000,5103,8897,94373.49928571428,113360.17636684304,83483.42250196695,11218,6166,5052,53069.54359065787,66504.7615958482,36671.76959619953,2880,1711,1169,28198.645833333332,25011.98129748685,32862.78870829769
60,Schenectady County--Schenectady City PUMA,47586,24493,23093,58586.56222418358,67523.13640632018,49108.21331139306,16858,8825,8033,80324.51061810416,95215.36543909348,63965.51724137931,27938,13952,13986,47513.113680292074,55153.904816513765,39890.89732589733,2790,1716,1074,38124.79569892473,25676.748251748253,58013.85474860335
61,"Clinton, Franklin, Essex & Hamilton Counties PUMA",53938,29238,24700,49197.04942712003,52193.1774403174,45650.45870445344,13444,5186,8258,62455.854061291284,74400.11029695334,54954.895858561395,37576,21604,15972,45564.87412177986,48556.07156082207,41518.92937640871,2918,2448,470,34882.878684030155,37246.64215686275,22571.191489361703
62,Onondaga County (Central)--Syracuse City (Outer) PUMA,52418,27238,25180,71089.01388835895,85192.86364637638,55832.43486894361,25116,13078,12038,97960.79272177098,123082.05612478973,70669.22578501412,25667,13235,12432,47407.35808625862,51765.945598791084,42767.2434041184,1635,925,710,30064.831804281344,27777.08108108108,33045.35211267605
63,"NYC-Queens Community District 11--Bayside, Douglaston & Little Neck PUMA",19157,10783,8374,71897.56538080075,73631.12770101085,69665.29854310963,11848,5902,5946,80657.64179608373,81894.11216536767,79430.3212243525,6753,4590,2163,56830.86332000593,61676.1220043573,46548.96902450301,556,291,265,68221.40287769784,94611.68384879726,39241.88679245283
64,"NYC-Staten Island Community District 3--Tottenville, Great Kills & Annadale PUMA",44314,25479,18835,83705.51180213928,99046.53911064014,62952.97478099283,21094,9476,11618,91970.47264625011,115506.12600253272,72774.06610432088,22617,15400,7217,76546.68169960649,90326.37142857142,47142.882083968405,603,603,0,63092.2056384743,63092.2056384743,0.0
65,Onondaga County (North) PUMA,50586,27680,22906,63524.40734590598,69446.9237716763,56367.53776303152,24075,11554,12521,75050.39003115265,85485.96157175004,65420.76032265794,25310,15493,9817,52233.96009482418,56493.580972051896,45511.50860751757,1201,633,568,70412.98917568693,93729.85781990521,44427.81690140845
66,Ulster County (East) PUMA,47663,25807,21856,65145.99353796446,71057.29298252412,58166.083912884336,19260,8612,10648,87575.39460020768,104987.00534138411,73493.05127723516,26771,15904,10867,49908.18759105002,53856.52477364185,44129.74325940922,1632,1291,341,50403.98284313725,56617.58326878389,26879.76539589443
67,Oswego County PUMA,38515,21397,17118,55005.23951707127,60631.99513950554,47971.959341044516,9828,3891,5937,70919.26638176639,77397.74608069904,66673.39060131379,25465,14902,10563,50954.82701747496,59782.566098510266,38500.887058600776,3222,2604,618,38475.35071384234,40441.00230414746,30192.89644012945
68,Niagara County (North & East) PUMA,36601,19829,16772,58011.72618234475,66062.80246104191,48493.195802528026,11480,4817,6663,74776.07839721255,102968.98692132032,54394.08224523488,24536,14632,9904,50645.84325073362,54474.18671405139,44989.91417609047,585,380,205,37968.205128205125,44451.05263157895,25951.219512195123
69,Broome (Outer West) & Tioga Counties PUMA,36485,20266,16219,61247.332054268874,68072.37787427218,52719.28602256613,11169,5621,5548,74084.4892112096,88731.74702010318,59244.5043258832,23652,13456,10196,57057.138931168614,61969.794887039236,50573.74362495096,1664,1189,475,34641.706730769234,39468.544995794786,22559.36842105263
70,"NYC-Bronx Community District 4--Concourse, Highbridge & Mount Eden PUMA",13843,8195,5648,44798.91280791736,48000.72971323978,40153.21706798867,3863,1973,1890,69388.93864871861,75528.02838317283,62980.24867724867,8301,5371,2930,38015.75713769425,41863.321541612364,30962.764505119452,1679,851,828,21758.832638475284,22915.72267920094,20569.806763285025
71,Suffolk County (Southwest)--Islip Town (South) PUMA,35229,20513,14716,81219.15609299157,93336.91805196705,64327.90500135907,19601,10597,9004,91118.11030049487,108510.52939511182,70648.6006219458,14803,9499,5304,67613.48713098696,73959.15359511528,56248.9536199095,825,417,408,90158.93333333333,149151.3669064748,29865.196078431374
72,Erie County (Central) PUMA,53793,28204,25589,52090.31769932891,58077.388313714364,45491.414279573255,16109,6688,9421,64219.619467378485,79491.39354066986,53378.13501751406,36399,20593,15806,47467.67795818566,52280.53804690915,41197.196634189546,1285,923,362,30976.342412451362,32246.045503791982,27738.950276243093
73,"NYC-Bronx Community District 8--Riverdale, Fieldston & Kingsbridge PUMA",20713,9349,11364,70773.97962632163,67784.00256711947,73233.7909186906,10246,3860,6386,88834.31875853991,84244.87823834197,91608.39336047604,8295,4014,4281,58626.764315852924,62531.94070752367,54965.14832982948,2172,1475,697,31968.692449355432,38999.457627118645,17090.10043041607
74,Chemung (South) & Steuben (East) Counties--Greater Elmira & Greater Corning Cities PUMA,30536,16921,13615,56424.60734870317,64369.35996690503,46550.70657363202,10913,5894,5019,73918.94346192614,85946.2945368171,59794.77385933453,18142,10020,8122,46489.591004299415,52311.32734530938,39307.39473036198,1481,1007,474,49216.89399054693,58060.55610724926,30428.776371308017
75,Nassau County (South Central)--Hempstead Town (Southeast) PUMA,30517,16535,13982,103799.88629288593,116352.17478076807,88955.65155199543,18734,9076,9658,127874.18543824063,152823.6326575584,104428.21495133569,11167,7403,3764,66229.71612787677,72273.60799675807,54342.646121147714,616,56,560,52725.48701298701,32400.0,54758.03571428572
76,"NYC-Queens Community District 13--Queens Village, Cambria Heights & Rosedale PUMA",33726,16784,16942,62707.063986242065,60075.76680171592,65313.82186282611,12616,4635,7981,81597.38902980342,79201.1736785329,82989.0013782734,20058,11240,8818,52140.317080466644,53677.48487544484,50180.942390564756,1052,909,143,37638.11787072243,41671.39713971397,12000.0
77,Cattaraugus & Allegany Counties PUMA,37478,21833,15645,48871.22418485511,51072.17331562314,45799.74304889741,8703,3811,4892,73216.31621280019,78458.2288113356,69132.72485690923,26959,16396,10563,42167.307392707444,46676.247255428156,35168.48338540187,1816,1626,190,31721.200440528635,31211.9926199262,36078.94736842105
78,"NYC-Queens Community District 7--Flushing, Murray Hill & Whitestone PUMA",27252,14500,12752,71894.62351387054,83245.94344827587,58987.30395232121,10865,5015,5850,90568.90289921768,112943.50149551345,71387.94358974359,15712,8964,6748,60158.39803971487,68554.7880410531,49004.687314759925,675,521,154,44492.444444444445,50152.39923224568,25344.155844155845
79,Jefferson & Lewis Counties PUMA,42071,26016,16055,48512.72705664234,51962.27475399754,42922.97726564933,12453,6039,6414,62558.88540913836,74541.99701937407,51276.3766760212,27919,18752,9167,43327.83194240482,46498.40123720137,36842.12065015818,1699,1225,474,30761.271336080048,24288.48979591837,47489.45147679325
80,"NYC-Brooklyn Community District 6--Park Slope, Carroll Gardens & Red Hook PUMA",43049,22426,20623,124993.25029617413,138461.185766521,110347.85821655433,37301,18724,18577,133520.13892388943,150363.45075838495,116543.54578241913,5004,3098,1906,59422.40807354117,61612.42737249839,55862.76495278069,744,604,140,138508.06451612903,163658.940397351,30000.0
81,NYC-Queens Community District 1--Astoria & Long Island City PUMA,48913,27369,21544,64725.6085294298,72818.13767401074,54445.04641663572,33124,17361,15763,72715.02626494385,84134.90351938253,60137.44020808222,14391,8753,5638,47546.12327148912,53172.92928138924,38810.50195104647,1398,1255,143,52271.03004291846,53283.58565737052,43384.61538461538
82,Saratoga County (Outer) PUMA,44423,24840,19583,70474.1739639376,79549.51086956522,58962.58898023796,18794,10231,8563,96734.9531765457,114333.6242791516,75708.20973957726,23329,12705,10624,53027.35822367011,58475.81739472649,46511.669804216865,2300,1904,396,32853.1652173913,33260.12605042017,30896.464646464647
83,Dutchess County (Southwest) PUMA,50539,27913,22626,76220.96551178298,84007.9484827858,66614.40422522761,22422,11387,11035,103233.51886540005,114367.15289365065,91744.73855913004,26660,15166,11494,55315.41245311328,64886.29671633918,42686.90795197494,1457,1360,97,43047.71448181194,43051.117647058825,43000.0
84,Erie County (Northwest) PUMA,39457,20463,18994,58120.555794915985,65069.200508234375,50634.501421501525,18815,9199,9616,68591.58809460537,82332.40243504729,55446.647254575706,19297,10560,8737,49730.48867699642,52447.01515151515,46447.151196062725,1345,704,641,32016.951672862455,28827.840909090908,35519.5007800312
85,Genesee & Orleans Counties PUMA,34380,19251,15129,47551.627865037815,52068.565061555244,41804.02009385947,7220,2729,4491,67641.11772853186,76406.98790765848,62314.45112447116,25451,15389,10062,42755.6518800833,49331.30651764247,32698.729874776385,1709,1133,576,34102.984201287305,30624.713150926742,40944.791666666664
86,Erie County (Northeast) PUMA,42742,25000,17742,73972.81432782744,84762.3032,58769.4989290948,22023,13043,8980,89899.53094492122,99597.11109407345,75814.28173719377,20483,11827,8656,57407.970512132015,69122.28460302697,41402.28743068392,236,130,106,25428.813559322032,19255.384615384617,33000.0
87,"NYC-Queens Community District 5--Ridgewood, Glendale & Middle Village PUMA",38684,20830,17854,63401.61772308965,67944.01680268843,58102.067323849,15838,7596,8242,72273.31733804774,82137.54739336493,63182.23610774084,21630,12213,9417,57288.86638927415,61823.45533447965,51407.91334820006,1216,1021,195,56583.22368421053,35560.43095004897,166656.41025641025
88,NYC-Brooklyn Community District 3--Bedford-Stuyvesant PUMA,42838,23037,19801,63963.4102899295,64486.97356426618,63354.28311701429,23788,12180,11608,81197.39238271398,81767.28325123152,80599.41936595451,17410,9710,7700,40558.87421022401,42188.24922760041,38504.168831168834,1640,1147,493,62445.73170731707,69758.50043591979,45432.04868154158
89,Nassau County (West Central)--Hempstead Town (West Central) PUMA,28627,14775,13852,79757.43598700527,80883.30287648053,78556.54923476755,14265,5681,8584,95937.67402733964,104299.45432142228,90403.74184529357,13991,9048,4943,64497.76284754485,66276.92307692308,61241.06817722031,371,46,325,33091.64420485175,62000.0,29000.0
90,Suffolk County (South Central)--Brookhaven Town (South) PUMA,36416,20903,15513,77837.97643892794,94157.89025498732,55847.6999935538,12608,6710,5898,103598.9942893401,133272.82414307006,69839.85588335029,21956,13069,8887,64818.76616870104,77110.85239880634,46742.331495442784,1852,1124,728,56809.28725701944,58861.20996441281,53641.20879120879
91,Orange County (Northeast)--Greater Newburgh City PUMA,36007,19617,16390,66705.0195795262,68153.02441759699,64971.91946308725,13714,6473,7241,79420.54688639347,86549.00818785725,73048.14942687475,19802,11059,8743,61751.48267851732,63150.47924767158,59981.89523047009,2491,2085,406,36078.44239261341,37575.539568345324,28390.147783251232
92,Sullivan & Ulster (West) Counties PUMA,27417,15617,11800,61297.65729292045,68118.9844400333,52269.80423728814,9006,3909,5097,84563.51432378414,104328.69276029675,69405.16970767119,16993,10653,6340,51602.66933443183,59061.1395850934,39070.321766561516,1418,1055,363,29714.17489421721,25417.061611374407,42203.030303030304
93,"NYC-Staten Island Community District 1--Port Richmond, Stapleton & Mariner's Harbor PUMA",36569,19810,16759,70452.19612239876,80870.52953054014,58137.19016647771,14693,7036,7657,86205.08065064996,104503.97953382604,69390.263810892,20202,11597,8605,61427.70072270072,70531.16236957833,49158.92155723416,1674,1177,497,41094.802867383514,41465.84536958369,40216.09657947686
94,Wayne & Seneca Counties PUMA,38648,21815,16833,51256.276133305735,58423.28031171212,41968.08055605061,10309,5203,5106,74422.32515277913,91839.72900249856,56674.0383862123,25711,14348,11363,42278.23927501847,47639.69542793421,35508.35694798909,2628,2264,364,48218.036529680365,49967.93286219081,37334.06593406593
95,Albany County (East Central)--Albany City PUMA,29394,15187,14207,62939.85473225828,60882.63909922961,65138.97726472865,17138,8548,8590,70348.9356984479,72896.93261581656,67813.39697322468,11544,5927,5617,53278.36365211365,45914.13193858613,61049.0243902439,712,712,0,41248.03370786517,41248.03370786517,0.0
96,Nassau County (Northwest)--North Hempstead Town (North) PUMA,23230,13810,9420,160524.6388291003,204547.28602461985,95986.12951167728,16132,10056,6076,200393.78626332755,244958.49443118536,126637.58064516129,6470,3422,3048,72494.28129829984,100112.97486849796,41486.679790026246,628,332,296,43307.00636942675,56954.21686746988,28000.0
97,Rensselaer County--Troy City PUMA,53887,29067,24820,66485.45047970754,77839.25482505934,53188.873892022566,21698,12465,9233,89126.4969121578,104394.11793020458,68514.46442109824,30565,15530,15035,51189.306069033206,57303.8596265293,44873.44196873961,1624,1072,552,51867.9802955665,66559.70149253731,23336.231884057972
98,Tompkins County PUMA,23614,12401,11213,63485.37520115186,73196.07854205306,52745.837866761794,12846,6209,6637,70052.31589599875,79199.97262038976,61494.563808949824,10255,6029,4226,55633.798147245245,68324.91955548184,37528.07856128727,513,163,350,55998.05068226121,24668.71165644172,70588.57142857143
99,Suffolk County (West Central)--Babylon Town (Northwest) PUMA,25226,13015,12211,66103.45080472529,76448.89127929312,55076.84301040046,9760,4532,5228,84478.18954918033,100014.21668137687,71010.46289211935,14533,7931,6602,53469.3538842634,61399.80960786786,43942.47652226598,933,552,381,70684.24437299036,99195.65217391304,29376.377952755905
100,NYC-Queens Community District 3--Jackson Heights & North Corona PUMA,14707,8885,5822,62595.18188617665,64502.08553742262,59685.04122294744,7640,3866,3774,76448.18848167539,80625.26642524573,72169.28457869634,6318,4954,1364,49611.93099081988,52569.38837303189,38870.54985337243,749,65,684,30807.743658210948,15000.0,32309.941520467837
101,NYC-Queens Community District 4--Elmhurst & South Corona PUMA,9141,5198,3943,48180.953943769826,50385.859946133125,45274.25817905148,4184,1875,2309,58262.45219885277,63435.36,54061.84495452577,3630,2404,1226,40138.12672176309,41697.3377703827,37080.75040783034,1327,919,408,38395.327807083646,46489.662676822634,20163.235294117647
102,Columbia & Greene Counties PUMA,33266,17018,16248,58081.426381290206,61354.894229639205,54652.827424913834,9864,3815,6049,89731.09286293593,98494.26998689384,84204.30815010746,22004,11946,10058,45204.31876022541,51935.17076845806,37210.00994233446,1398,1257,141,37448.78397711016,38157.836117740655,31127.659574468085
103,Madison & Cortland Counties PUMA,37984,21912,16072,52362.9873104465,56725.294359255204,46415.57117969139,12476,5344,7132,69980.84241744148,86433.84730538922,57652.62338754907,23365,15011,8354,44372.71217633212,48191.29105322764,37511.24610964807,2143,1557,586,36913.81241250583,37034.489402697494,36593.17406143345
104,NYC-Queens Community District 6--Forest Hills & Rego Park PUMA,23908,13881,10027,86153.5929396018,93792.80959585044,75578.14999501346,16561,8837,7724,94890.65273836121,104930.08826524839,83404.57146556188,6482,4247,2235,68662.9126812712,78687.9679773958,49613.06487695749,865,797,68,49945.66473988439,50794.22835633626,40000.0
105,NYC-Brooklyn Community District 5--East New York & Starrett City PUMA,29783,13453,16330,46289.5564583823,49046.77246710771,44018.10349050827,5566,2077,3489,58687.20804886813,57190.024073182474,59578.48094009745,20717,9308,11409,43867.219191967946,49027.54619681994,39657.18117275835,3500,2068,1432,40911.90857142857,40954.61798839458,40850.23044692737
106,"NYC-Bronx Community District 5--Morris Heights, Fordham South & Mount Hope PUMA",11743,7150,4593,33574.24167589202,32029.874125874125,35978.38449814936,2003,257,1746,50122.21667498752,61408.56031128405,48460.93928980527,7119,5608,1511,35107.23697148476,34075.142653352355,38937.80277961615,2621,1285,1336,16764.250286150324,17228.17120622568,16318.038922155689
107,NYC-Brooklyn Community District 8--Crown Heights North & Prospect Heights PUMA,40513,19651,20862,75277.34302569546,86493.83329092668,64711.94899817851,26286,10912,15374,91691.87742524537,115719.08266129032,74638.09418498764,11557,7120,4437,47624.603270745,53258.13483146067,38584.54361054767,2670,1619,1051,33371.074157303374,35679.90611488573,29814.462416745955
108,"Steuben (North & West), Schuyler & Chemung (North) Counties PUMA",28944,16106,12838,46228.59625483693,50873.38507388551,40401.44492911668,6111,2607,3504,60250.02290950745,72548.18181818182,51100.10844748859,21304,12369,8935,42420.14128802103,46278.24642250788,37079.24566312255,1529,1130,399,43253.04774362328,51166.37168141593,20841.879699248122
109,Herkimer (North & Central) & Oneida (Outer) Counties PUMA,35274,21126,14148,49310.1665249192,56104.97652182145,39164.05711054566,8327,4523,3804,73793.46103038309,93566.29449480433,50283.333333333336,25239,15571,9668,42191.31756408732,46238.81471967119,35672.53620190319,1708,1032,676,35141.686182669786,40783.72093023256,26528.402366863906
110,Livingston & Wyoming Counties PUMA,33544,19177,14367,51614.824111614595,55529.68295353809,46389.290039674255,9325,3896,5429,64053.81018766756,71952.90554414784,58385.201694603056,23247,14427,8820,47148.51034542092,51885.218687183755,39400.60884353742,972,854,118,39099.23868312757,42173.48946135832,16850.0
111,Putnam County PUMA,31148,16721,14427,89092.93116733017,107391.56330363016,67884.68080682054,15197,7658,7539,111600.259919721,145902.4275267694,76756.64677012866,15681,8854,6827,68067.88278808749,75709.1190422408,58157.892192764026,270,209,61,43351.851851851854,38492.82296650718,60000.0
112,"NYC-Brooklyn Community District 17--East Flatbush, Farragut & Rugby PUMA",22669,11196,11473,47816.021880100576,48738.99607002501,46915.33164821756,10359,4380,5979,59122.78212182643,66136.50684931508,53984.78006355578,11541,6093,5448,38141.57352049216,37272.16477925488,39113.91336270191,769,723,46,40697.78933680104,39978.69986168741,52000.0
113,Suffolk County (Northwest)--Huntington Town (North) PUMA,25234,13311,11923,107060.79694063566,130105.34895950717,81333.54440996393,16746,8383,8363,127905.7207691389,162789.94989860433,92938.06648331939,7919,4570,3349,67902.17830534159,76763.79649890591,55809.73424902956,569,358,211,38568.71704745167,45680.4469273743,26502.369668246447
114,"NYC-Bronx Community District 12--Wakefield, Williamsbridge & Woodlawn PUMA",22671,11192,11479,56220.24745269287,62262.07469621158,50329.47904869762,6913,2828,4085,63149.836539852455,54552.1216407355,69101.9388004896,13562,7560,6002,55789.15941601534,68105.09788359789,40276.24791736088,2196,804,1392,37068.22859744991,34439.30348258706,38586.65948275862
115,NYC-Manhattan Community District 3--Chinatown & Lower East Side PUMA,33010,19009,14001,88386.6004241139,95504.20432426746,78723.109777873,25096,13294,11802,101909.71589097864,119308.23454189861,82311.68954414506,7537,5452,2085,46358.34549555526,40500.57776962582,61675.635491606714,377,263,114,28415.384615384617,32496.577946768062,19000.0
116,Nassau County (East Central)--Oyster Bay Town (Central) PUMA,24725,13052,11673,107862.2786653185,123435.80064357953,90448.9651332134,16059,7528,8531,125645.90759075907,150724.7104144527,103515.64998241706,8550,5524,3026,75272.42222222222,86247.00398262129,55238.189028420355,116,0,116,48000.0,0.0,48000.0
117,Westchester County (South Central)--New Rochelle & Mount Vernon Cities PUMA,49678,25595,24083,108375.13023873747,132951.55225630006,82255.72976788606,28943,13753,15190,148522.4468783471,197262.13335272303,104393.61816984859,18825,10598,8227,54068.63426294821,62285.3708246839,43483.85559742312,1910,1244,666,35252.61780104712,23993.97106109325,56282.282282282285
118,Orange County (Northwest) PUMA,32526,18988,13538,60696.476357375635,66746.26342953445,52211.22322351898,9732,4260,5472,80497.36230990547,95838.45774647887,68554.18494152046,20751,13298,7453,54394.84651342104,61828.878026770944,41130.690996913996,2043,1430,613,30379.735682819384,25808.251748251747,41044.04567699837
119,Nassau County (Central)--Hempstead Town (East Central) PUMA,33389,20331,13058,105207.19488454281,119813.84978604103,82464.97549395007,19336,10385,8951,123822.94580057923,149118.42368801156,94474.99162104793,13785,9678,4107,80097.33405875952,90200.42880760488,56289.74920866813,268,268,0,53659.701492537315,53659.701492537315,0.0
120,Monroe County (North & West) PUMA,37556,18838,18718,55598.706997550325,62142.48327847967,49012.9789507426,14597,6451,8146,67353.42193601425,76934.67679429546,59765.81144119814,21593,11374,10219,49891.32774510258,57562.84508528222,41352.73901555925,1366,1013,353,20207.686676427526,19362.981243830207,22631.72804532578
121,Suffolk County (Northwest)--Smithtown Town PUMA,39442,24591,14851,105921.65458141068,116754.88471391973,87983.47114672413,24496,14338,10158,127866.39247224036,146273.94476217046,101884.16322110652,14789,10162,4627,70026.1511934546,75699.62113757135,57565.85260427923,157,91,66,63248.4076433121,50373.62637362637,81000.0
122,Broome County (West Central)--Greater Binghamton City & Greater Johnson City Village PUMA,28137,14413,13724,51933.31023207876,59108.30153333796,44398.10550859808,9737,5402,4335,75336.4198418404,85720.71269900037,62396.17762399077,16716,7752,8964,40021.90894950945,44055.67079463365,36533.54194556002,1684,1259,425,34851.90023752969,37605.32168387609,26695.29411764706
123,"NYC-Brooklyn Community District 12--Borough Park, Kensington & Ocean Parkway PUMA",17354,11303,6051,61420.74853059813,62270.129169247106,59834.14311684019,7255,4171,3084,70825.97105444521,72040.25893071207,69183.69001297017,8089,5263,2826,56892.37853875633,60099.05947178415,50920.41755130927,2010,1869,141,45696.91542288557,46579.98929909042,33991.48936170213
124,Suffolk County (Central)--Brookhaven Town (Central) PUMA,38752,19547,19205,68424.53524979355,81203.38619737043,55418.12028117678,14371,6412,7959,85253.8932572542,112349.82376793512,63424.629978640536,22966,12435,10531,59210.58477749717,66618.37716123844,50463.466907226284,1415,700,715,47048.48056537103,54994.28571428572,39269.37062937063
125,NYC-Queens Community District 10--Howard Beach & Ozone Park PUMA,20341,10528,9813,62832.34108450912,63520.64399696048,62093.88668093346,8891,3998,4893,65193.88707681926,71272.02101050525,60227.531166973225,10744,6286,4458,55514.696574832466,58925.19885459752,50705.7200538358,706,244,462,144453.11614730879,54901.639344262294,191748.7012987013
126,Erie County (South) PUMA,59754,31554,28200,61663.21852930348,71359.40990048806,50813.799290780145,23255,11410,11845,82652.81745861105,97834.53812445223,68028.63571127057,35892,19840,16052,48394.0011701772,56441.690524193546,38447.19349613755,607,304,303,42133.7726523888,51248.68421052631,32988.77887788779
127,"NYC-Bronx Community District 11--Pelham Parkway, Morris Park & Laconia PUMA",24448,12069,12379,54291.54245746073,56011.79550915569,52614.36868890864,8841,3704,5137,67606.87026354484,72241.57667386609,64265.045746544674,13927,6992,6935,46738.19128311912,48910.763729977116,44547.76207642394,1680,1373,307,46836.01190476191,48390.02184996358,39885.99348534202
128,"NYC-Queens Community District 14--Far Rockaway, Breezy Point & Broad Channel PUMA",26261,13319,12942,67657.37405277789,81536.05375778962,53374.408901251736,9381,3350,6031,100991.70664108304,157016.2985074627,69872.09418006965,15606,9365,6241,50382.27604767397,56376.689802455956,41387.29370293222,1274,604,670,33815.77708006279,52990.72847682119,16529.701492537315
129,"NYC-Bronx Community District 10--Co-op City, Pelham Bay & Schuylerville PUMA",29450,15436,14014,62033.011884550084,64983.39919668308,58783.24889396318,12131,5260,6871,65531.687412414474,67505.79847908745,64020.433706884,16418,9409,7009,60128.66366183457,64839.27622489106,53805.05778285062,901,767,134,49628.07991120977,49453.06388526728,50629.850746268654
130,Nassau County (West Central)--North Hempstead Town (South) PUMA,24223,13349,10874,88671.22074061842,99371.04352385947,75536.04193489057,13573,6246,7327,104198.35555883004,126084.41562600064,85541.28838542377,10457,6977,3480,69309.08482356316,76138.62691701304,55616.637931034486,193,126,67,45769.9481865285,61600.0,16000.0
131,Monroe County (Central)--Greece & Gates Towns PUMA,44082,23226,20856,49203.37938387551,52277.00637216912,45780.476601457616,10938,4489,6449,66347.27372462973,82161.07596346625,55339.65110869902,31229,17460,13769,44238.02843510839,46249.907216494845,41686.833466482676,1915,1277,638,32254.569190600523,29632.96789350039,37501.880877742944
132,"NYC-Manhattan Community District 12--Washington Heights, Inwood & Marble Hill PUMA",44951,21727,23224,60125.39276100643,63374.220555069725,57085.98174302446,26753,10428,16325,74526.30097559153,89564.69025700039,64920.155589586524,15374,9827,5547,40767.009236373095,39925.50117024524,42257.81503515414,2824,1472,1352,29087.252124645893,34377.17391304348,23327.810650887575
133,"NYC-Brooklyn Community District 15--Sheepshead Bay, Gerritsen Beach & Homecrest PUMA",17023,8556,8467,69170.97926334958,76481.52875175315,61783.58568560293,10222,3951,6271,75687.05537076893,84481.69071121234,70146.0564503269,6523,4327,2196,57488.195615514334,67427.73284030506,37903.32422586521,278,278,0,103701.43884892086,103701.43884892086,0.0
134,"NYC-Bronx Community District 3 & 6--Belmont, Crotona Park East & East Tremont PUMA",23603,12275,11328,40434.1541329492,50377.15682281059,29659.93467514124,4583,2231,2352,62760.46257909666,85650.64993276558,41047.87414965987,14830,7769,7061,37008.21308159137,44212.0993692882,29081.999716754002,4190,2275,1915,28139.46062052506,36839.20879120879,17804.250652741513
135,Nassau County (Southwest)--Hempstead Town (Southwest) & Long Beach City PUMA,25149,15578,9571,105735.83402918605,120483.85030170754,81731.59231010344,15973,9360,6613,126859.14981531334,147655.75854700856,97423.75623771359,8827,5955,2872,70391.10569842528,81672.96725440807,46998.52715877437,349,263,86,32914.04011461318,32231.9391634981,35000.0
136,NYC-Brooklyn Community District 13--Brighton Beach & Coney Island PUMA,10241,3962,6279,65649.81935357876,85592.27662796568,53066.28444019749,4946,1459,3487,96929.23574605741,156281.42563399588,72095.61227416118,4265,2445,1820,39108.11254396249,44802.37218813906,31458.406593406595,1030,58,972,25351.165048543688,26900.0,25258.744855967077
137,NYC-Manhattan Community District 8--Upper East Side PUMA,75350,33372,41978,154229.28387524883,181213.25842023254,132777.35194625755,69110,28286,40824,157964.81637968455,191444.80520398784,134767.31089555164,5377,4223,1154,75235.14599218895,78747.90433341227,62380.3986135182,863,863,0,347263.8470451912,347263.8470451912,0.0
138,NYC-Brooklyn Community District 7--Sunset Park & Windsor Terrace PUMA,22752,12678,10074,82114.81540084389,91795.62864805174,69931.63589438157,15138,7840,7298,103662.20108336637,124368.23979591837,81418.38859961633,6287,3888,2399,44279.287418482585,44540.42695473251,43856.06502709462,1327,950,377,15564.43104747551,16384.0,13499.204244031831
139,"NYC-Bronx Community District 7--Bedford Park, Fordham North & Norwood PUMA",15724,8365,7359,42894.57262783007,42856.186491332934,42938.206278026904,5224,1593,3631,56153.169984686065,56621.7827997489,55947.57917928945,8356,6105,2251,39576.05313547152,39668.05896805897,39326.521545979565,2144,667,1477,23522.667910447763,39160.41979010495,16460.798916723088
140,Monroe County (East) PUMA,45745,24092,21653,63886.933435348124,69739.71940893242,57374.88800628088,23077,11511,11566,77795.73818087274,84832.50369212058,70792.43472246239,22433,12473,9960,50001.00387821513,56293.62382746733,42120.69779116466,235,108,127,23587.23404255319,14000.0,31740.15748031496
141,Suffolk County (East) PUMA,39169,21877,17292,84956.01393959508,93409.58312382868,74260.96807772381,16512,8092,8420,122755.78851744186,151131.8302026693,95485.13182897863,20572,11918,8654,58543.6287186467,61814.707165631815,54038.80864340189,2085,1867,218,46205.75539568345,44914.30101767542,57266.05504587156
142,"NYC-Queens Community District 8--Briarwood, Fresh Meadows & Hillcrest PUMA",23624,12847,10777,61494.5690822892,65984.70693547132,56141.98478240698,11982,5235,6747,76467.08646302788,88250.28844317097,67324.49533125834,11380,7350,4030,46098.33655536028,50856.49931972789,37420.297766749376,262,262,0,45496.18320610687,45496.18320610687,0.0
143,"NYC-Bronx Community District 9--Castle Hill, Clason Point & Parkchester PUMA",28625,12304,16321,51169.23318777292,49292.70968790637,52583.8980454629,7897,1435,6462,68107.00265923768,75266.89895470384,66517.02259362426,19509,10131,9378,45357.59905684556,46054.85144605666,44604.36127105993,1219,738,481,34451.92780968006,43235.50135501355,20975.259875259875
144,Suffolk County (Central)--Islip Town (Northwest) PUMA,21243,9697,11546,56202.302876241585,61695.65845106734,51588.6644725446,5199,2153,3046,68618.28428543951,68430.46911286577,68751.03742613264,13283,6897,6386,54661.81284348415,60864.11483253589,47963.210147196995,2761,647,2114,40234.04563563926,48148.68624420402,37811.731315042576
145,NYC-Manhattan Community District 7--Upper West Side & West Side PUMA,69070,34040,35030,196825.68814246418,251558.9098119859,143639.3088781045,63451,30513,32938,204428.19246347575,265078.52030282177,148243.13407007104,5239,3527,1712,117317.62550104981,134597.221434647,81718.83177570094,380,0,380,23552.63157894737,0.0,23552.63157894737
146,Capital Region,358015,192673,165342,65387.58552015977,73143.19364934371,56349.97689637237,148630,75511,73119,86855.25970530849,102084.30957079101,71128.00981960913,194825,106341,88484,51043.0234826126,56061.52377728251,45011.73715021925,14560,10821,3739,38185.58585164835,39052.92948895666,35675.4158866007
147,Central NY,247251,133993,113258,61030.70636721388,68734.25395356474,51916.811969132425,94987,45212,49775,82769.0844010233,99742.86693798106,67351.33139126067,140227,80565,59662,48046.69970833007,53809.35393781419,40265.05916663873,12037,8216,3821,40746.996759990034,44447.88096397273,32789.27244176917
148,Finger Lakes,386384,209665,176719,58658.761506687646,65032.138010636016,51097.1864372252,148917,71883,77034,78851.85902213985,92218.06254608183,66379.4077939611,220592,125563,95029,46639.593666134766,51844.25878642594,39762.60488903387,16875,12219,4656,37576.496,40619.65463622228,29590.165378006874
149,Long Island,758100,428056,330044,93066.1660862683,108131.23392733661,73527.27830228697,386353,200486,185867,118213.17724982076,143693.76315553207,90728.46643029693,352432,215793,136639,67699.47147251101,77727.89970017564,51861.646162515826,19315,11777,7538,52911.45275692467,59819.90405026747,42118.0286548156
150,Mid-Hudson,596923,330064,266859,94474.47281475166,110588.52530418344,74543.84045507178,308298,152938,155360,128103.01516714347,164299.52229007834,92470.79705200825,268120,162014,106106,59993.70675816799,66456.34492080931,50125.858952368384,20505,15112,5393,39725.41867837113,40153.01813128639,38527.2204709809
151,Mohawk Valley,149712,83455,66257,52260.665437640266,58727.28409322389,44115.53873552983,43998,21142,22856,75037.01827355789,95637.3654337338,55981.51688834442,96311,55876,40435,43655.812669373176,47211.3264013172,38742.547298132806,9403,6437,2966,33822.7204083803,37461.58769613174,25925.421443020903
152,New York City,1702285,884664,817621,87092.10339161774,96307.39691227404,77121.17746486452,998699,471553,527146,112282.40046700758,131223.23943225894,95339.06894864042,629532,366786,262746,52190.55209266566,57309.68183082233,45044.39146552183,74054,46325,27729,44071.04974748157,49661.86288181328,34730.84929135562
153,North Country,124719,71447,53272,49701.411990153865,53318.8454658698,44849.80571407118,35169,15485,19684,64843.32770337513,77981.384694866,54507.88711643975,83773,51299,32474,44632.242488629985,47947.20969219673,39395.60694709614,5777,4663,1114,31029.697074606196,30513.81085138323,33189.102333931776
154,Southern Tier,178220,97132,81088,54836.21125575132,61282.69653667175,47114.2300956985,59555,29273,30282,71357.03517756696,82629.19413794282,60460.46595337164,110479,62328,48151,46928.734601145916,52630.515979976895,39548.18944570206,8186,5531,2655,41363.50720742731,45805.763876333396,32109.224105461395
155,Western NY,448031,241515,206516,57422.31879044084,63566.16777425833,50237.24989831296,172695,83438,89257,75783.5544167463,87981.88511229896,64380.47884199559,260545,148642,111903,46594.91941891036,51565.92201396644,39991.88136153633,14791,9435,5356,33768.149550402275,36702.56491785903,28598.95444361464
